"filename", "language", "Dart", "comment", "blank", "total"
"/Users/morikazu/Downloads/StudyHub_student/lib/application/answer/application_service/answer_dto.dart", "Dart", 45, 0, 4, 49
"/Users/morikazu/Downloads/StudyHub_student/lib/application/answer/application_service/decrement_answer_like_use_case.dart", "Dart", 20, 0, 4, 24
"/Users/morikazu/Downloads/StudyHub_student/lib/application/answer/application_service/get_answer_use_case.dart", "Dart", 11, 0, 4, 15
"/Users/morikazu/Downloads/StudyHub_student/lib/application/answer/application_service/i_get_answer_query_service.dart", "Dart", 5, 0, 2, 7
"/Users/morikazu/Downloads/StudyHub_student/lib/application/answer/application_service/increment_answer_like_use_case.dart", "Dart", 20, 0, 5, 25
"/Users/morikazu/Downloads/StudyHub_student/lib/application/answer/exception/answer_use_case_exception.dart", "Dart", 8, 0, 2, 10
"/Users/morikazu/Downloads/StudyHub_student/lib/application/answer/exception/answer_use_case_exception_detail.dart", "Dart", 8, 0, 5, 13
"/Users/morikazu/Downloads/StudyHub_student/lib/application/blockings/application_service/blockings_add_use_case.dart", "Dart", 20, 0, 8, 28
"/Users/morikazu/Downloads/StudyHub_student/lib/application/blockings/application_service/blockings_delete_use_case.dart", "Dart", 24, 0, 7, 31
"/Users/morikazu/Downloads/StudyHub_student/lib/application/blockings/application_service/get_blocking_dto.dart", "Dart", 12, 0, 4, 16
"/Users/morikazu/Downloads/StudyHub_student/lib/application/blockings/application_service/get_blockings_use_case.dart", "Dart", 17, 0, 4, 21
"/Users/morikazu/Downloads/StudyHub_student/lib/application/blockings/application_service/i_get_blockings_query_service.dart", "Dart", 5, 0, 2, 7
"/Users/morikazu/Downloads/StudyHub_student/lib/application/blockings/exception/blockings_use_case_exception.dart", "Dart", 8, 0, 2, 10
"/Users/morikazu/Downloads/StudyHub_student/lib/application/blockings/exception/blockings_use_case_exception_detail.dart", "Dart", 8, 0, 5, 13
"/Users/morikazu/Downloads/StudyHub_student/lib/application/bookmarks/application_service/bookmarks_add_use_case.dart", "Dart", 20, 0, 8, 28
"/Users/morikazu/Downloads/StudyHub_student/lib/application/bookmarks/application_service/bookmarks_delete_use_case.dart", "Dart", 24, 0, 7, 31
"/Users/morikazu/Downloads/StudyHub_student/lib/application/bookmarks/application_service/get_my_bookmarks_use_case.dart", "Dart", 17, 0, 4, 21
"/Users/morikazu/Downloads/StudyHub_student/lib/application/bookmarks/application_service/i_get_bookmarks_query_service.dart", "Dart", 5, 0, 2, 7
"/Users/morikazu/Downloads/StudyHub_student/lib/application/bookmarks/exception/bookmarks_use_case_exception.dart", "Dart", 8, 0, 2, 10
"/Users/morikazu/Downloads/StudyHub_student/lib/application/bookmarks/exception/bookmarks_use_case_exception_detail.dart", "Dart", 8, 0, 5, 13
"/Users/morikazu/Downloads/StudyHub_student/lib/application/di/answer/query_service/answer_query_service_provider.dart", "Dart", 37, 0, 4, 41
"/Users/morikazu/Downloads/StudyHub_student/lib/application/di/answer/query_service/answer_query_service_provider.g.dart", "Dart", 16, 7, 6, 29
"/Users/morikazu/Downloads/StudyHub_student/lib/application/di/answer/repository/answer_repository_provider.dart", "Dart", 17, 0, 4, 21
"/Users/morikazu/Downloads/StudyHub_student/lib/application/di/answer/repository/answer_repository_provider.g.dart", "Dart", 15, 7, 6, 28
"/Users/morikazu/Downloads/StudyHub_student/lib/application/di/bookmarks/query_service/get_my_bookmarks_query_service_provider.dart", "Dart", 35, 0, 4, 39
"/Users/morikazu/Downloads/StudyHub_student/lib/application/di/bookmarks/query_service/get_my_bookmarks_query_service_provider.g.dart", "Dart", 16, 7, 6, 29
"/Users/morikazu/Downloads/StudyHub_student/lib/application/di/bookmarks/repository/get_my_bookmarks_repository_provider.dart", "Dart", 18, 0, 4, 22
"/Users/morikazu/Downloads/StudyHub_student/lib/application/di/bookmarks/repository/get_my_bookmarks_repository_provider.g.dart", "Dart", 16, 7, 6, 29
"/Users/morikazu/Downloads/StudyHub_student/lib/application/di/favorite_teacher/query_service/get_favorite_teacher_query_service_provider.dart", "Dart", 27, 0, 4, 31
"/Users/morikazu/Downloads/StudyHub_student/lib/application/di/favorite_teacher/query_service/get_favorite_teacher_query_service_provider.g.dart", "Dart", 16, 7, 6, 29
"/Users/morikazu/Downloads/StudyHub_student/lib/application/di/favorite_teacher/repository/favorite_teacher_repository_provider.dart", "Dart", 18, 0, 4, 22
"/Users/morikazu/Downloads/StudyHub_student/lib/application/di/favorite_teacher/repository/favorite_teacher_repository_provider.g.dart", "Dart", 16, 7, 6, 29
"/Users/morikazu/Downloads/StudyHub_student/lib/application/di/liked_answers/query_service/liked_answers_query_service_provider.dart", "Dart", 25, 0, 4, 29
"/Users/morikazu/Downloads/StudyHub_student/lib/application/di/liked_answers/query_service/liked_answers_query_service_provider.g.dart", "Dart", 16, 7, 6, 29
"/Users/morikazu/Downloads/StudyHub_student/lib/application/di/liked_answers/repository/liked_answers_repository_provider.dart", "Dart", 18, 0, 4, 22
"/Users/morikazu/Downloads/StudyHub_student/lib/application/di/liked_answers/repository/liked_answers_repository_provider.g.dart", "Dart", 16, 7, 6, 29
"/Users/morikazu/Downloads/StudyHub_student/lib/application/di/notification/factory/notification_factory_provider.dart", "Dart", 19, 0, 4, 23
"/Users/morikazu/Downloads/StudyHub_student/lib/application/di/notification/factory/notification_factory_provider.g.dart", "Dart", 15, 7, 6, 28
"/Users/morikazu/Downloads/StudyHub_student/lib/application/di/notification/repository/notification_repository_provider.dart", "Dart", 18, 0, 4, 22
"/Users/morikazu/Downloads/StudyHub_student/lib/application/di/notification/repository/notification_repository_provider.g.dart", "Dart", 16, 7, 6, 29
"/Users/morikazu/Downloads/StudyHub_student/lib/application/di/photo/photo_repository_provider.dart", "Dart", 17, 0, 4, 21
"/Users/morikazu/Downloads/StudyHub_student/lib/application/di/photo/photo_repository_provider.g.dart", "Dart", 14, 7, 6, 27
"/Users/morikazu/Downloads/StudyHub_student/lib/application/di/question/factory/question_factory_provider.dart", "Dart", 20, 0, 4, 24
"/Users/morikazu/Downloads/StudyHub_student/lib/application/di/question/factory/question_factory_provider.g.dart", "Dart", 14, 7, 6, 27
"/Users/morikazu/Downloads/StudyHub_student/lib/application/di/question/query_service/get_question_query_service_provider.dart", "Dart", 31, 0, 4, 35
"/Users/morikazu/Downloads/StudyHub_student/lib/application/di/question/query_service/get_question_query_service_provider.g.dart", "Dart", 16, 7, 6, 29
"/Users/morikazu/Downloads/StudyHub_student/lib/application/di/question/query_service/get_recommended_questions_query_service_provider.dart", "Dart", 31, 0, 4, 35
"/Users/morikazu/Downloads/StudyHub_student/lib/application/di/question/query_service/get_recommended_questions_query_service_provider.g.dart", "Dart", 16, 7, 6, 29
"/Users/morikazu/Downloads/StudyHub_student/lib/application/di/question/query_service/question_create_query_service.dart", "Dart", 20, 0, 4, 24
"/Users/morikazu/Downloads/StudyHub_student/lib/application/di/question/query_service/question_create_query_service.g.dart", "Dart", 16, 7, 6, 29
"/Users/morikazu/Downloads/StudyHub_student/lib/application/di/question/query_service/search_for_questions_query_service_provider.dart", "Dart", 31, 0, 4, 35
"/Users/morikazu/Downloads/StudyHub_student/lib/application/di/question/query_service/search_for_questions_query_service_provider.g.dart", "Dart", 16, 7, 6, 29
"/Users/morikazu/Downloads/StudyHub_student/lib/application/di/question/repository/question_repository_provider.dart", "Dart", 17, 0, 4, 21
"/Users/morikazu/Downloads/StudyHub_student/lib/application/di/question/repository/question_repository_provider.g.dart", "Dart", 15, 7, 6, 28
"/Users/morikazu/Downloads/StudyHub_student/lib/application/di/question_detail/question_detail_query_service_provider.dart", "Dart", 21, 0, 4, 25
"/Users/morikazu/Downloads/StudyHub_student/lib/application/di/question_detail/question_detail_query_service_provider.g.dart", "Dart", 16, 7, 6, 29
"/Users/morikazu/Downloads/StudyHub_student/lib/application/di/report/question_report_repository_provider.dart", "Dart", 18, 0, 4, 22
"/Users/morikazu/Downloads/StudyHub_student/lib/application/di/report/question_report_repository_provider.g.dart", "Dart", 16, 7, 6, 29
"/Users/morikazu/Downloads/StudyHub_student/lib/application/di/report/teacher_report_repository_provider.dart", "Dart", 18, 0, 4, 22
"/Users/morikazu/Downloads/StudyHub_student/lib/application/di/report/teacher_report_repository_provider.g.dart", "Dart", 16, 7, 6, 29
"/Users/morikazu/Downloads/StudyHub_student/lib/application/di/school/school_repository_provider.dart", "Dart", 17, 0, 4, 21
"/Users/morikazu/Downloads/StudyHub_student/lib/application/di/school/school_repository_provider.g.dart", "Dart", 15, 7, 6, 28
"/Users/morikazu/Downloads/StudyHub_student/lib/application/di/session/session_provider.dart", "Dart", 34, 0, 7, 41
"/Users/morikazu/Downloads/StudyHub_student/lib/application/di/session/session_provider.g.dart", "Dart", 47, 10, 12, 69
"/Users/morikazu/Downloads/StudyHub_student/lib/application/di/student/get_my_profile_query_service.dart", "Dart", 21, 0, 4, 25
"/Users/morikazu/Downloads/StudyHub_student/lib/application/di/student/get_my_profile_query_service.g.dart", "Dart", 16, 7, 6, 29
"/Users/morikazu/Downloads/StudyHub_student/lib/application/di/student/student_provider.dart", "Dart", 17, 0, 4, 21
"/Users/morikazu/Downloads/StudyHub_student/lib/application/di/student/student_provider.g.dart", "Dart", 15, 7, 6, 28
"/Users/morikazu/Downloads/StudyHub_student/lib/application/di/student/student_repository_provider.dart", "Dart", 17, 0, 4, 21
"/Users/morikazu/Downloads/StudyHub_student/lib/application/di/student/student_repository_provider.g.dart", "Dart", 15, 7, 6, 28
"/Users/morikazu/Downloads/StudyHub_student/lib/application/di/student_auth/student_auth_provider.dart", "Dart", 42, 0, 6, 48
"/Users/morikazu/Downloads/StudyHub_student/lib/application/di/student_auth/student_auth_provider.g.dart", "Dart", 42, 9, 10, 61
"/Users/morikazu/Downloads/StudyHub_student/lib/application/di/teacher/get_popular_teacher_query_service_provider.dart", "Dart", 22, 0, 4, 26
"/Users/morikazu/Downloads/StudyHub_student/lib/application/di/teacher/get_popular_teacher_query_service_provider.g.dart", "Dart", 16, 7, 6, 29
"/Users/morikazu/Downloads/StudyHub_student/lib/application/di/teacher/get_teacher_profile_query_service.dart", "Dart", 30, 0, 4, 34
"/Users/morikazu/Downloads/StudyHub_student/lib/application/di/teacher/get_teacher_profile_query_service.g.dart", "Dart", 16, 7, 6, 29
"/Users/morikazu/Downloads/StudyHub_student/lib/application/di/teacher/search_for_teachers_query_service.dart", "Dart", 21, 0, 4, 25
"/Users/morikazu/Downloads/StudyHub_student/lib/application/di/teacher/search_for_teachers_query_service.g.dart", "Dart", 16, 7, 6, 29
"/Users/morikazu/Downloads/StudyHub_student/lib/application/di/teacher/teacher_provider.dart", "Dart", 17, 0, 4, 21
"/Users/morikazu/Downloads/StudyHub_student/lib/application/di/teacher/teacher_provider.g.dart", "Dart", 15, 7, 6, 28
"/Users/morikazu/Downloads/StudyHub_student/lib/application/di/teacher_evaluation/teacher_evaluation_repository_provider.dart", "Dart", 18, 0, 4, 22
"/Users/morikazu/Downloads/StudyHub_student/lib/application/di/teacher_evaluation/teacher_evaluation_repository_provider.g.dart", "Dart", 16, 7, 6, 29
"/Users/morikazu/Downloads/StudyHub_student/lib/application/favorite_teachers/application_service/favorite_teachers_add_use_case.dart", "Dart", 21, 0, 8, 29
"/Users/morikazu/Downloads/StudyHub_student/lib/application/favorite_teachers/application_service/favorite_teachers_delete_use_case.dart", "Dart", 24, 0, 7, 31
"/Users/morikazu/Downloads/StudyHub_student/lib/application/favorite_teachers/application_service/get_favorite_teacher_dto.dart", "Dart", 20, 0, 4, 24
"/Users/morikazu/Downloads/StudyHub_student/lib/application/favorite_teachers/application_service/get_favorite_teacher_use_case.dart", "Dart", 17, 0, 5, 22
"/Users/morikazu/Downloads/StudyHub_student/lib/application/favorite_teachers/application_service/i_get_favorite_teacher_query_service.dart", "Dart", 5, 0, 2, 7
"/Users/morikazu/Downloads/StudyHub_student/lib/application/favorite_teachers/exception/favorite_teachers_use_case_exception.dart", "Dart", 8, 0, 2, 10
"/Users/morikazu/Downloads/StudyHub_student/lib/application/favorite_teachers/exception/favorite_teachers_use_case_exception_detail.dart", "Dart", 8, 0, 5, 13
"/Users/morikazu/Downloads/StudyHub_student/lib/application/liked_answers/application_service/get_liked_answers_use_case.dart", "Dart", 11, 0, 4, 15
"/Users/morikazu/Downloads/StudyHub_student/lib/application/liked_answers/application_service/i_get_liked_answers_query_service.dart", "Dart", 5, 0, 2, 7
"/Users/morikazu/Downloads/StudyHub_student/lib/application/liked_answers/application_service/liked_answers_dto.dart", "Dart", 6, 0, 4, 10
"/Users/morikazu/Downloads/StudyHub_student/lib/application/notification/application_service/get_my_notification_dto.dart", "Dart", 17, 0, 3, 20
"/Users/morikazu/Downloads/StudyHub_student/lib/application/notification/application_service/get_my_notifications_use_case.dart", "Dart", 17, 0, 4, 21
"/Users/morikazu/Downloads/StudyHub_student/lib/application/notification/application_service/i_get_my_notifications_query_service.dart", "Dart", 5, 0, 2, 7
"/Users/morikazu/Downloads/StudyHub_student/lib/application/question/application_service/get_my_questions_use_case.dart", "Dart", 17, 0, 3, 20
"/Users/morikazu/Downloads/StudyHub_student/lib/application/question/application_service/get_question_detail_use_case.dart", "Dart", 36, 0, 4, 40
"/Users/morikazu/Downloads/StudyHub_student/lib/application/question/application_service/get_recommended_questions_use_case.dart", "Dart", 21, 0, 3, 24
"/Users/morikazu/Downloads/StudyHub_student/lib/application/question/application_service/get_trending_question_use_case.dart", "Dart", 11, 0, 5, 16
"/Users/morikazu/Downloads/StudyHub_student/lib/application/question/application_service/i_get_my_questions_query_service.dart", "Dart", 5, 0, 2, 7
"/Users/morikazu/Downloads/StudyHub_student/lib/application/question/application_service/i_get_question_detail_query_service.dart", "Dart", 5, 0, 2, 7
"/Users/morikazu/Downloads/StudyHub_student/lib/application/question/application_service/i_get_recommended_questions_query_service.dart", "Dart", 9, 0, 2, 11
"/Users/morikazu/Downloads/StudyHub_student/lib/application/question/application_service/i_get_trending_question_query_service.dart", "Dart", 5, 0, 2, 7
"/Users/morikazu/Downloads/StudyHub_student/lib/application/question/application_service/i_question_create_query_service.dart", "Dart", 5, 0, 2, 7
"/Users/morikazu/Downloads/StudyHub_student/lib/application/question/application_service/i_search_for_questions_query_service.dart", "Dart", 8, 0, 2, 10
"/Users/morikazu/Downloads/StudyHub_student/lib/application/question/application_service/question_create_use_case.dart", "Dart", 136, 0, 17, 153
"/Users/morikazu/Downloads/StudyHub_student/lib/application/question/application_service/question_delete_use_case.dart", "Dart", 37, 0, 9, 46
"/Users/morikazu/Downloads/StudyHub_student/lib/application/question/application_service/question_detail_dto.dart", "Dart", 24, 0, 4, 28
"/Users/morikazu/Downloads/StudyHub_student/lib/application/question/application_service/question_edit_command.dart", "Dart", 24, 0, 4, 28
"/Users/morikazu/Downloads/StudyHub_student/lib/application/question/application_service/question_edit_use_case.dart", "Dart", 76, 3, 17, 96
"/Users/morikazu/Downloads/StudyHub_student/lib/application/question/application_service/search_for_question_use_case.dart", "Dart", 15, 0, 4, 19
"/Users/morikazu/Downloads/StudyHub_student/lib/application/question/application_service/utils/photo_processing.dart", "Dart", 62, 0, 16, 78
"/Users/morikazu/Downloads/StudyHub_student/lib/application/question/exception/question_use_case_exception.dart", "Dart", 8, 0, 2, 10
"/Users/morikazu/Downloads/StudyHub_student/lib/application/question/exception/question_use_case_exception_detail.dart", "Dart", 12, 0, 5, 17
"/Users/morikazu/Downloads/StudyHub_student/lib/application/report/application_service/question_report_submit_command.dart", "Dart", 17, 0, 4, 21
"/Users/morikazu/Downloads/StudyHub_student/lib/application/report/application_service/question_report_submit_use_case.dart", "Dart", 27, 0, 6, 33
"/Users/morikazu/Downloads/StudyHub_student/lib/application/report/application_service/teacher_report_submit_command.dart", "Dart", 17, 0, 4, 21
"/Users/morikazu/Downloads/StudyHub_student/lib/application/report/application_service/teacher_report_submit_use_case.dart", "Dart", 27, 0, 6, 33
"/Users/morikazu/Downloads/StudyHub_student/lib/application/shared/application_service/question_card_dto.dart", "Dart", 32, 0, 4, 36
"/Users/morikazu/Downloads/StudyHub_student/lib/application/shared/exception/use_case_exception.dart", "Dart", 13, 0, 4, 17
"/Users/morikazu/Downloads/StudyHub_student/lib/application/shared/exception/use_case_exception_detail.dart", "Dart", 4, 0, 2, 6
"/Users/morikazu/Downloads/StudyHub_student/lib/application/shared/flavor/flavor.dart", "Dart", 5, 0, 1, 6
"/Users/morikazu/Downloads/StudyHub_student/lib/application/shared/flavor/flavor_config.dart", "Dart", 14, 0, 3, 17
"/Users/morikazu/Downloads/StudyHub_student/lib/application/shared/session/i_session_provider.dart", "Dart", 4, 0, 2, 6
"/Users/morikazu/Downloads/StudyHub_student/lib/application/shared/session/session.dart", "Dart", 8, 0, 4, 12
"/Users/morikazu/Downloads/StudyHub_student/lib/application/student/application_service/get_my_profile_dto.dart", "Dart", 20, 0, 4, 24
"/Users/morikazu/Downloads/StudyHub_student/lib/application/student/application_service/get_my_profile_use_case.dart", "Dart", 23, 0, 4, 27
"/Users/morikazu/Downloads/StudyHub_student/lib/application/student/application_service/get_student_dto.dart", "Dart", 52, 0, 5, 57
"/Users/morikazu/Downloads/StudyHub_student/lib/application/student/application_service/get_student_use_case.dart", "Dart", 22, 0, 4, 26
"/Users/morikazu/Downloads/StudyHub_student/lib/application/student/application_service/i_get_my_profile_query_service.dart", "Dart", 5, 0, 2, 7
"/Users/morikazu/Downloads/StudyHub_student/lib/application/student/application_service/profile_update_command.dart", "Dart", 30, 0, 4, 34
"/Users/morikazu/Downloads/StudyHub_student/lib/application/student/application_service/profile_update_use_case.dart", "Dart", 88, 0, 16, 104
"/Users/morikazu/Downloads/StudyHub_student/lib/application/student/application_service/student_create_use_case.dart", "Dart", 61, 7, 13, 81
"/Users/morikazu/Downloads/StudyHub_student/lib/application/student/application_service/student_delete_use_case.dart", "Dart", 32, 1, 3, 36
"/Users/morikazu/Downloads/StudyHub_student/lib/application/student/application_service/utils/photo_processing.dart", "Dart", 53, 0, 11, 64
"/Users/morikazu/Downloads/StudyHub_student/lib/application/student/exception/student_use_case_exception.dart", "Dart", 8, 0, 2, 10
"/Users/morikazu/Downloads/StudyHub_student/lib/application/student/exception/student_use_case_exception_detail.dart", "Dart", 13, 0, 5, 18
"/Users/morikazu/Downloads/StudyHub_student/lib/application/student_auth/application_service/i_get_student_auth_query_service.dart", "Dart", 4, 0, 2, 6
"/Users/morikazu/Downloads/StudyHub_student/lib/application/student_auth/application_service/sign_in_use_case.dart", "Dart", 17, 0, 4, 21
"/Users/morikazu/Downloads/StudyHub_student/lib/application/student_auth/application_service/sign_out_use_case.dart", "Dart", 10, 0, 3, 13
"/Users/morikazu/Downloads/StudyHub_student/lib/application/student_auth/application_service/student_auth_info_without_password.dart", "Dart", 17, 0, 4, 21
"/Users/morikazu/Downloads/StudyHub_student/lib/application/student_auth/application_service/update_student_auth_info_command.dart", "Dart", 11, 0, 3, 14
"/Users/morikazu/Downloads/StudyHub_student/lib/application/student_auth/application_service/update_student_auth_info_use_case.dart", "Dart", 21, 0, 5, 26
"/Users/morikazu/Downloads/StudyHub_student/lib/application/student_auth/exception/student_auth_use_case_exception.dart", "Dart", 8, 0, 2, 10
"/Users/morikazu/Downloads/StudyHub_student/lib/application/student_auth/exception/student_auth_use_case_exception_detail.dart", "Dart", 10, 10, 6, 26
"/Users/morikazu/Downloads/StudyHub_student/lib/application/teacher/application_service/get_popular_teachers_use_case.dart", "Dart", 9, 0, 3, 12
"/Users/morikazu/Downloads/StudyHub_student/lib/application/teacher/application_service/get_teacher_profile_dto.dart", "Dart", 39, 0, 3, 42
"/Users/morikazu/Downloads/StudyHub_student/lib/application/teacher/application_service/get_teacher_profile_use_case.dart", "Dart", 15, 0, 3, 18
"/Users/morikazu/Downloads/StudyHub_student/lib/application/teacher/application_service/i_get_popular_teachers_query_service.dart", "Dart", 4, 0, 2, 6
"/Users/morikazu/Downloads/StudyHub_student/lib/application/teacher/application_service/i_get_teacher_profile_query_service.dart", "Dart", 5, 0, 2, 7
"/Users/morikazu/Downloads/StudyHub_student/lib/application/teacher/application_service/i_search_for_teachers_query_service.dart", "Dart", 4, 0, 2, 6
"/Users/morikazu/Downloads/StudyHub_student/lib/application/teacher/application_service/search_for_teachers_dto.dart", "Dart", 20, 0, 4, 24
"/Users/morikazu/Downloads/StudyHub_student/lib/application/teacher/application_service/search_for_teachers_use_case.dart", "Dart", 14, 0, 3, 17
"/Users/morikazu/Downloads/StudyHub_student/lib/application/teacher_evaluation/application_service/get_teacher_evaluation_dto.dart", "Dart", 25, 0, 4, 29
"/Users/morikazu/Downloads/StudyHub_student/lib/application/teacher_evaluation/application_service/get_teacher_evaluation_use_case.dart", "Dart", 26, 0, 8, 34
"/Users/morikazu/Downloads/StudyHub_student/lib/application/teacher_evaluation/application_service/teacher_evaluation_add_use_case.dart", "Dart", 39, 0, 8, 47
"/Users/morikazu/Downloads/StudyHub_student/lib/application/teacher_evaluation/exception/teacher_evaluation_use_case_exception.dart", "Dart", 8, 0, 2, 10
"/Users/morikazu/Downloads/StudyHub_student/lib/application/teacher_evaluation/exception/teacher_evaluation_use_case_exception_detail.dart", "Dart", 8, 0, 5, 13
"/Users/morikazu/Downloads/StudyHub_student/lib/domain/answer_list/exception/answer_domain_exception.dart", "Dart", 8, 0, 2, 10
"/Users/morikazu/Downloads/StudyHub_student/lib/domain/answer_list/exception/answer_domain_exception_detail.dart", "Dart", 20, 0, 5, 25
"/Users/morikazu/Downloads/StudyHub_student/lib/domain/answer_list/models/answer.dart", "Dart", 37, 8, 6, 51
"/Users/morikazu/Downloads/StudyHub_student/lib/domain/answer_list/models/answer_id.dart", "Dart", 17, 0, 5, 22
"/Users/morikazu/Downloads/StudyHub_student/lib/domain/answer_list/models/answer_like.dart", "Dart", 45, 0, 8, 53
"/Users/morikazu/Downloads/StudyHub_student/lib/domain/answer_list/models/answer_list.dart", "Dart", 8, 8, 7, 23
"/Users/morikazu/Downloads/StudyHub_student/lib/domain/answer_list/models/answer_photo.dart", "Dart", 29, 0, 5, 34
"/Users/morikazu/Downloads/StudyHub_student/lib/domain/answer_list/models/answer_photo_format.dart", "Dart", 11, 0, 4, 15
"/Users/morikazu/Downloads/StudyHub_student/lib/domain/answer_list/models/answer_photo_path.dart", "Dart", 16, 0, 4, 20
"/Users/morikazu/Downloads/StudyHub_student/lib/domain/answer_list/models/answer_photo_path_list.dart", "Dart", 15, 0, 4, 19
"/Users/morikazu/Downloads/StudyHub_student/lib/domain/answer_list/models/answer_text.dart", "Dart", 17, 0, 3, 20
"/Users/morikazu/Downloads/StudyHub_student/lib/domain/answer_list/models/i_answer_repository.dart", "Dart", 9, 0, 2, 11
"/Users/morikazu/Downloads/StudyHub_student/lib/domain/blockings/exception/blockings_domain_exception.dart", "Dart", 8, 0, 2, 10
"/Users/morikazu/Downloads/StudyHub_student/lib/domain/blockings/exception/blockings_domain_exception_detail.dart", "Dart", 9, 0, 5, 14
"/Users/morikazu/Downloads/StudyHub_student/lib/domain/blockings/models/blockings.dart", "Dart", 39, 0, 9, 48
"/Users/morikazu/Downloads/StudyHub_student/lib/domain/blockings/models/i_blockings_repository.dart", "Dart", 6, 0, 2, 8
"/Users/morikazu/Downloads/StudyHub_student/lib/domain/bookmarks/exception/bookmarks_domain_exception.dart", "Dart", 8, 0, 2, 10
"/Users/morikazu/Downloads/StudyHub_student/lib/domain/bookmarks/exception/bookmarks_domain_exception_detail.dart", "Dart", 9, 0, 5, 14
"/Users/morikazu/Downloads/StudyHub_student/lib/domain/bookmarks/models/bookmarks.dart", "Dart", 34, 0, 9, 43
"/Users/morikazu/Downloads/StudyHub_student/lib/domain/bookmarks/models/i_bookmarks_repository.dart", "Dart", 6, 0, 2, 8
"/Users/morikazu/Downloads/StudyHub_student/lib/domain/favorite_teachers/exception/favorite_teachers_domain_exception.dart", "Dart", 8, 0, 2, 10
"/Users/morikazu/Downloads/StudyHub_student/lib/domain/favorite_teachers/exception/favorite_teachers_domain_exception_detail.dart", "Dart", 12, 0, 6, 18
"/Users/morikazu/Downloads/StudyHub_student/lib/domain/favorite_teachers/models/favorite_teachers.dart", "Dart", 44, 0, 9, 53
"/Users/morikazu/Downloads/StudyHub_student/lib/domain/favorite_teachers/models/i_favorite_teachers_repository.dart", "Dart", 6, 0, 2, 8
"/Users/morikazu/Downloads/StudyHub_student/lib/domain/liked_answer/models/i_liked_answers_repository.dart", "Dart", 8, 0, 2, 10
"/Users/morikazu/Downloads/StudyHub_student/lib/domain/liked_answer/models/liked_answers.dart", "Dart", 8, 0, 5, 13
"/Users/morikazu/Downloads/StudyHub_student/lib/domain/notification/exception/notification_domain_exception.dart", "Dart", 8, 0, 2, 10
"/Users/morikazu/Downloads/StudyHub_student/lib/domain/notification/exception/notification_domain_exception_detail.dart", "Dart", 24, 0, 5, 29
"/Users/morikazu/Downloads/StudyHub_student/lib/domain/notification/models/i_notification_factory.dart", "Dart", 15, 0, 2, 17
"/Users/morikazu/Downloads/StudyHub_student/lib/domain/notification/models/i_notification_repository.dart", "Dart", 6, 0, 2, 8
"/Users/morikazu/Downloads/StudyHub_student/lib/domain/notification/models/notification.dart", "Dart", 33, 0, 4, 37
"/Users/morikazu/Downloads/StudyHub_student/lib/domain/notification/models/notification_id.dart", "Dart", 17, 0, 4, 21
"/Users/morikazu/Downloads/StudyHub_student/lib/domain/notification/models/notification_receiver.dart", "Dart", 54, 0, 7, 61
"/Users/morikazu/Downloads/StudyHub_student/lib/domain/notification/models/notification_receiver_list.dart", "Dart", 15, 0, 5, 20
"/Users/morikazu/Downloads/StudyHub_student/lib/domain/notification/models/notification_receiver_type.dart", "Dart", 4, 0, 1, 5
"/Users/morikazu/Downloads/StudyHub_student/lib/domain/notification/models/notification_sender.dart", "Dart", 66, 2, 6, 74
"/Users/morikazu/Downloads/StudyHub_student/lib/domain/notification/models/notification_sender_type.dart", "Dart", 5, 0, 1, 6
"/Users/morikazu/Downloads/StudyHub_student/lib/domain/notification/models/notification_target.dart", "Dart", 44, 0, 5, 49
"/Users/morikazu/Downloads/StudyHub_student/lib/domain/notification/models/notification_target_type.dart", "Dart", 5, 0, 1, 6
"/Users/morikazu/Downloads/StudyHub_student/lib/domain/notification/models/notification_text.dart", "Dart", 22, 0, 4, 26
"/Users/morikazu/Downloads/StudyHub_student/lib/domain/notification/models/notification_title.dart", "Dart", 18, 0, 4, 22
"/Users/morikazu/Downloads/StudyHub_student/lib/domain/photo/models/i_profile_photo_repository.dart", "Dart", 8, 0, 2, 10
"/Users/morikazu/Downloads/StudyHub_student/lib/domain/photo/models/photo.dart", "Dart", 27, 0, 6, 33
"/Users/morikazu/Downloads/StudyHub_student/lib/domain/photo/models/photo_path.dart", "Dart", 21, 0, 6, 27
"/Users/morikazu/Downloads/StudyHub_student/lib/domain/photo/models/photo_path_list.dart", "Dart", 11, 0, 6, 17
"/Users/morikazu/Downloads/StudyHub_student/lib/domain/question/exception/question_domain_exception.dart", "Dart", 8, 0, 2, 10
"/Users/morikazu/Downloads/StudyHub_student/lib/domain/question/exception/question_domain_exception_detail.dart", "Dart", 26, 0, 5, 31
"/Users/morikazu/Downloads/StudyHub_student/lib/domain/question/models/i_question_factory.dart", "Dart", 17, 8, 4, 29
"/Users/morikazu/Downloads/StudyHub_student/lib/domain/question/models/i_question_repository.dart", "Dart", 8, 0, 2, 10
"/Users/morikazu/Downloads/StudyHub_student/lib/domain/question/models/question.dart", "Dart", 88, 2, 16, 106
"/Users/morikazu/Downloads/StudyHub_student/lib/domain/question/models/question_id.dart", "Dart", 17, 0, 4, 21
"/Users/morikazu/Downloads/StudyHub_student/lib/domain/question/models/question_photo.dart", "Dart", 30, 0, 6, 36
"/Users/morikazu/Downloads/StudyHub_student/lib/domain/question/models/question_photo_format.dart", "Dart", 11, 0, 4, 15
"/Users/morikazu/Downloads/StudyHub_student/lib/domain/question/models/question_photo_path.dart", "Dart", 16, 0, 4, 20
"/Users/morikazu/Downloads/StudyHub_student/lib/domain/question/models/question_photo_path_list.dart", "Dart", 15, 7, 5, 27
"/Users/morikazu/Downloads/StudyHub_student/lib/domain/question/models/question_text.dart", "Dart", 22, 0, 3, 25
"/Users/morikazu/Downloads/StudyHub_student/lib/domain/question/models/question_title.dart", "Dart", 18, 0, 3, 21
"/Users/morikazu/Downloads/StudyHub_student/lib/domain/question/models/seen_count.dart", "Dart", 41, 2, 9, 52
"/Users/morikazu/Downloads/StudyHub_student/lib/domain/question/models/selected_teacher_list.dart", "Dart", 17, 0, 5, 22
"/Users/morikazu/Downloads/StudyHub_student/lib/domain/report/exception/report_domain_exception.dart", "Dart", 8, 0, 2, 10
"/Users/morikazu/Downloads/StudyHub_student/lib/domain/report/exception/report_domain_exception_detail.dart", "Dart", 11, 0, 5, 16
"/Users/morikazu/Downloads/StudyHub_student/lib/domain/report/models/i_question_report_repository.dart", "Dart", 4, 0, 2, 6
"/Users/morikazu/Downloads/StudyHub_student/lib/domain/report/models/i_teacher_report_repository.dart", "Dart", 4, 0, 2, 6
"/Users/morikazu/Downloads/StudyHub_student/lib/domain/report/models/question_report.dart", "Dart", 15, 0, 3, 18
"/Users/morikazu/Downloads/StudyHub_student/lib/domain/report/models/report_reason.dart", "Dart", 15, 0, 6, 21
"/Users/morikazu/Downloads/StudyHub_student/lib/domain/report/models/report_text.dart", "Dart", 21, 0, 4, 25
"/Users/morikazu/Downloads/StudyHub_student/lib/domain/report/models/teacher_report.dart", "Dart", 15, 0, 3, 18
"/Users/morikazu/Downloads/StudyHub_student/lib/domain/school/models/i_school_repository.dart", "Dart", 5, 0, 2, 7
"/Users/morikazu/Downloads/StudyHub_student/lib/domain/school/models/school.dart", "Dart", 19, 0, 6, 25
"/Users/morikazu/Downloads/StudyHub_student/lib/domain/school/models/school_type.dart", "Dart", 11, 0, 4, 15
"/Users/morikazu/Downloads/StudyHub_student/lib/domain/school/services/school_service.dart", "Dart", 13, 0, 4, 17
"/Users/morikazu/Downloads/StudyHub_student/lib/domain/shared/domain_exception.dart", "Dart", 13, 0, 4, 17
"/Users/morikazu/Downloads/StudyHub_student/lib/domain/shared/domain_exception_detail.dart", "Dart", 4, 0, 2, 6
"/Users/morikazu/Downloads/StudyHub_student/lib/domain/shared/id.dart", "Dart", 21, 0, 6, 27
"/Users/morikazu/Downloads/StudyHub_student/lib/domain/shared/name.dart", "Dart", 31, 0, 5, 36
"/Users/morikazu/Downloads/StudyHub_student/lib/domain/shared/profile_photo.dart", "Dart", 34, 0, 6, 40
"/Users/morikazu/Downloads/StudyHub_student/lib/domain/shared/profile_photo_format.dart", "Dart", 11, 0, 4, 15
"/Users/morikazu/Downloads/StudyHub_student/lib/domain/shared/profile_photo_path.dart", "Dart", 16, 0, 4, 20
"/Users/morikazu/Downloads/StudyHub_student/lib/domain/shared/subject.dart", "Dart", 12, 0, 4, 16
"/Users/morikazu/Downloads/StudyHub_student/lib/domain/student/exception/student_domain_exception.dart", "Dart", 8, 0, 2, 10
"/Users/morikazu/Downloads/StudyHub_student/lib/domain/student/exception/student_domain_exception_detail.dart", "Dart", 19, 0, 5, 24
"/Users/morikazu/Downloads/StudyHub_student/lib/domain/student/models/gender.dart", "Dart", 12, 0, 4, 16
"/Users/morikazu/Downloads/StudyHub_student/lib/domain/student/models/grade_or_graduate_status.dart", "Dart", 13, 0, 4, 17
"/Users/morikazu/Downloads/StudyHub_student/lib/domain/student/models/i_student_repository.dart", "Dart", 7, 0, 2, 9
"/Users/morikazu/Downloads/StudyHub_student/lib/domain/student/models/occupation.dart", "Dart", 12, 0, 4, 16
"/Users/morikazu/Downloads/StudyHub_student/lib/domain/student/models/question_count.dart", "Dart", 38, 0, 8, 46
"/Users/morikazu/Downloads/StudyHub_student/lib/domain/student/models/school_name.dart", "Dart", 0, 18, 5, 23
"/Users/morikazu/Downloads/StudyHub_student/lib/domain/student/models/status.dart", "Dart", 13, 0, 5, 18
"/Users/morikazu/Downloads/StudyHub_student/lib/domain/student/models/student.dart", "Dart", 116, 0, 15, 131
"/Users/morikazu/Downloads/StudyHub_student/lib/domain/student/models/student_id.dart", "Dart", 17, 0, 5, 22
"/Users/morikazu/Downloads/StudyHub_student/lib/domain/student_auth/exception/student_auth_domain_exception.dart", "Dart", 8, 0, 2, 10
"/Users/morikazu/Downloads/StudyHub_student/lib/domain/student_auth/exception/student_auth_domain_exception_detail.dart", "Dart", 13, 0, 5, 18
"/Users/morikazu/Downloads/StudyHub_student/lib/domain/student_auth/models/email_address.dart", "Dart", 36, 0, 6, 42
"/Users/morikazu/Downloads/StudyHub_student/lib/domain/student_auth/models/i_student_auth_repository.dart", "Dart", 20, 0, 2, 22
"/Users/morikazu/Downloads/StudyHub_student/lib/domain/student_auth/models/password.dart", "Dart", 39, 0, 7, 46
"/Users/morikazu/Downloads/StudyHub_student/lib/domain/student_auth/models/student_auth_info.dart", "Dart", 32, 0, 7, 39
"/Users/morikazu/Downloads/StudyHub_student/lib/domain/teacher/exception/teacher_domain_exception.dart", "Dart", 8, 0, 2, 10
"/Users/morikazu/Downloads/StudyHub_student/lib/domain/teacher/exception/teacher_domain_exception_detail.dart", "Dart", 16, 0, 5, 21
"/Users/morikazu/Downloads/StudyHub_student/lib/domain/teacher/models/bio.dart", "Dart", 13, 0, 4, 17
"/Users/morikazu/Downloads/StudyHub_student/lib/domain/teacher/models/graduated.dart", "Dart", 10, 0, 4, 14
"/Users/morikazu/Downloads/StudyHub_student/lib/domain/teacher/models/high_school.dart", "Dart", 4, 0, 2, 6
"/Users/morikazu/Downloads/StudyHub_student/lib/domain/teacher/models/i_teacher_repository.dart", "Dart", 5, 0, 2, 7
"/Users/morikazu/Downloads/StudyHub_student/lib/domain/teacher/models/introduction.dart", "Dart", 13, 0, 4, 17
"/Users/morikazu/Downloads/StudyHub_student/lib/domain/teacher/models/rating.dart", "Dart", 14, 0, 4, 18
"/Users/morikazu/Downloads/StudyHub_student/lib/domain/teacher/models/teacher.dart", "Dart", 48, 0, 4, 52
"/Users/morikazu/Downloads/StudyHub_student/lib/domain/teacher/models/teacher_id.dart", "Dart", 17, 0, 5, 22
"/Users/morikazu/Downloads/StudyHub_student/lib/domain/teacher/models/university.dart", "Dart", 11, 0, 4, 15
"/Users/morikazu/Downloads/StudyHub_student/lib/domain/teacher_evaluation/exception/teacher_evaluation_domain_exception.dart", "Dart", 8, 0, 2, 10
"/Users/morikazu/Downloads/StudyHub_student/lib/domain/teacher_evaluation/exception/teacher_evaluation_domain_exception_detail.dart", "Dart", 13, 0, 6, 19
"/Users/morikazu/Downloads/StudyHub_student/lib/domain/teacher_evaluation/models/i_teacher_evaluation_repository.dart", "Dart", 6, 0, 2, 8
"/Users/morikazu/Downloads/StudyHub_student/lib/domain/teacher_evaluation/models/teacher_evaluation.dart", "Dart", 27, 0, 4, 31
"/Users/morikazu/Downloads/StudyHub_student/lib/domain/teacher_evaluation/models/teacher_evaluation_comment.dart", "Dart", 14, 0, 4, 18
"/Users/morikazu/Downloads/StudyHub_student/lib/domain/teacher_evaluation/models/teacher_evaluation_rating.dart", "Dart", 14, 0, 5, 19
"/Users/morikazu/Downloads/StudyHub_student/lib/firebase_options.dart", "Dart", 64, 12, 6, 82
"/Users/morikazu/Downloads/StudyHub_student/lib/main.dart", "Dart", 10, 0, 2, 12
"/Users/morikazu/Downloads/StudyHub_student/lib/presentation/auth/tmp.dart", "Dart", 15, 5, 6, 26
"/Users/morikazu/Downloads/StudyHub_student/lib/presentation/auth/tmp.g.dart", "Dart", 12, 7, 6, 25
"/Users/morikazu/Downloads/StudyHub_student/lib/presentation/components/parts/bottom_sheet_for_pick_image.dart", "Dart", 65, 0, 4, 69
"/Users/morikazu/Downloads/StudyHub_student/lib/presentation/components/parts/button_for_profile_input_back.dart", "Dart", 31, 0, 5, 36
"/Users/morikazu/Downloads/StudyHub_student/lib/presentation/components/parts/button_for_profile_input_next.dart", "Dart", 42, 1, 5, 48
"/Users/morikazu/Downloads/StudyHub_student/lib/presentation/components/parts/button_for_profile_input_skip.dart", "Dart", 31, 0, 5, 36
"/Users/morikazu/Downloads/StudyHub_student/lib/presentation/components/parts/circle_avatar_for_profile_edit.dart", "Dart", 51, 0, 6, 57
"/Users/morikazu/Downloads/StudyHub_student/lib/presentation/components/parts/completion_snack_bar.dart", "Dart", 25, 0, 3, 28
"/Users/morikazu/Downloads/StudyHub_student/lib/presentation/components/parts/drop_down_button_for_gender_input.dart", "Dart", 74, 0, 7, 81
"/Users/morikazu/Downloads/StudyHub_student/lib/presentation/components/parts/drop_down_button_for_occupation_input.dart", "Dart", 74, 0, 7, 81
"/Users/morikazu/Downloads/StudyHub_student/lib/presentation/components/parts/drop_down_button_for_others_grade_input.dart", "Dart", 78, 0, 7, 85
"/Users/morikazu/Downloads/StudyHub_student/lib/presentation/components/parts/drop_down_button_for_report_reason.dart", "Dart", 71, 0, 6, 77
"/Users/morikazu/Downloads/StudyHub_student/lib/presentation/components/parts/drop_down_button_for_student_grade_input.dart", "Dart", 78, 0, 7, 85
"/Users/morikazu/Downloads/StudyHub_student/lib/presentation/components/parts/dropdown_for_question_subject.dart", "Dart", 55, 0, 4, 59
"/Users/morikazu/Downloads/StudyHub_student/lib/presentation/components/parts/elevated_button_for_auth.dart", "Dart", 42, 0, 5, 47
"/Users/morikazu/Downloads/StudyHub_student/lib/presentation/components/parts/elevated_button_for_create_question.dart", "Dart", 39, 0, 5, 44
"/Users/morikazu/Downloads/StudyHub_student/lib/presentation/components/parts/elevated_button_for_menu_items.dart", "Dart", 52, 0, 5, 57
"/Users/morikazu/Downloads/StudyHub_student/lib/presentation/components/parts/progress_bar.dart", "Dart", 48, 0, 5, 53
"/Users/morikazu/Downloads/StudyHub_student/lib/presentation/components/parts/sample_button.dart", "Dart", 23, 1, 4, 28
"/Users/morikazu/Downloads/StudyHub_student/lib/presentation/components/parts/text_button_for_adding_picture.dart", "Dart", 62, 0, 5, 67
"/Users/morikazu/Downloads/StudyHub_student/lib/presentation/components/parts/text_button_for_follow_teacher.dart", "Dart", 33, 0, 5, 38
"/Users/morikazu/Downloads/StudyHub_student/lib/presentation/components/parts/text_button_for_navigating_to_evaluatin_page.dart", "Dart", 59, 0, 5, 64
"/Users/morikazu/Downloads/StudyHub_student/lib/presentation/components/parts/text_button_for_selecting_teachers.dart", "Dart", 57, 0, 5, 62
"/Users/morikazu/Downloads/StudyHub_student/lib/presentation/components/parts/text_button_for_unfollow_teacher.dart", "Dart", 33, 0, 5, 38
"/Users/morikazu/Downloads/StudyHub_student/lib/presentation/components/parts/text_for_error.dart", "Dart", 19, 1, 4, 24
"/Users/morikazu/Downloads/StudyHub_student/lib/presentation/components/parts/text_for_input_explanation.dart", "Dart", 26, 0, 5, 31
"/Users/morikazu/Downloads/StudyHub_student/lib/presentation/components/parts/text_for_menu_items.dart", "Dart", 26, 0, 5, 31
"/Users/morikazu/Downloads/StudyHub_student/lib/presentation/components/parts/text_for_no_evaluation_found.dart", "Dart", 17, 0, 4, 21
"/Users/morikazu/Downloads/StudyHub_student/lib/presentation/components/parts/text_for_no_favorite_teacher_found.dart", "Dart", 18, 0, 4, 22
"/Users/morikazu/Downloads/StudyHub_student/lib/presentation/components/parts/text_for_no_question_found.dart", "Dart", 18, 0, 4, 22
"/Users/morikazu/Downloads/StudyHub_student/lib/presentation/components/parts/text_for_notification_section_header.dart", "Dart", 19, 0, 5, 24
"/Users/morikazu/Downloads/StudyHub_student/lib/presentation/components/parts/text_for_profile_completion_welcome.dart", "Dart", 24, 0, 4, 28
"/Users/morikazu/Downloads/StudyHub_student/lib/presentation/components/parts/text_for_reset_password_email_address_input_explanation.dart", "Dart", 35, 0, 4, 39
"/Users/morikazu/Downloads/StudyHub_student/lib/presentation/components/parts/text_form_field_for_add_question.dart", "Dart", 48, 0, 5, 53
"/Users/morikazu/Downloads/StudyHub_student/lib/presentation/components/parts/text_form_field_for_add_question_title.dart", "Dart", 48, 0, 5, 53
"/Users/morikazu/Downloads/StudyHub_student/lib/presentation/components/parts/text_form_field_for_email_address_input.dart", "Dart", 62, 0, 6, 68
"/Users/morikazu/Downloads/StudyHub_student/lib/presentation/components/parts/text_form_field_for_evaluation_input.dart", "Dart", 53, 0, 5, 58
"/Users/morikazu/Downloads/StudyHub_student/lib/presentation/components/parts/text_form_field_for_password_input.dart", "Dart", 61, 0, 6, 67
"/Users/morikazu/Downloads/StudyHub_student/lib/presentation/components/parts/text_form_field_for_report_input.dart", "Dart", 63, 0, 5, 68
"/Users/morikazu/Downloads/StudyHub_student/lib/presentation/components/parts/text_form_field_for_school_name_input.dart", "Dart", 61, 5, 6, 72
"/Users/morikazu/Downloads/StudyHub_student/lib/presentation/components/parts/text_form_field_for_search_teachers.dart", "Dart", 53, 1, 5, 59
"/Users/morikazu/Downloads/StudyHub_student/lib/presentation/components/parts/text_form_field_for_user_name_input.dart", "Dart", 64, 5, 6, 75
"/Users/morikazu/Downloads/StudyHub_student/lib/presentation/components/widgets/academic_history_input_widget.dart", "Dart", 67, 0, 7, 74
"/Users/morikazu/Downloads/StudyHub_student/lib/presentation/components/widgets/account_related_menu_widget.dart", "Dart", 41, 0, 5, 46
"/Users/morikazu/Downloads/StudyHub_student/lib/presentation/components/widgets/add_images_or_select_teacher_widget.dart", "Dart", 60, 0, 4, 64
"/Users/morikazu/Downloads/StudyHub_student/lib/presentation/components/widgets/add_question_main_content_widget.dart", "Dart", 54, 0, 4, 58
"/Users/morikazu/Downloads/StudyHub_student/lib/presentation/components/widgets/answer_card_widget.dart", "Dart", 187, 5, 9, 201
"/Users/morikazu/Downloads/StudyHub_student/lib/presentation/components/widgets/answer_menu_modal_widget.dart", "Dart", 137, 1, 7, 145
"/Users/morikazu/Downloads/StudyHub_student/lib/presentation/components/widgets/answer_picture_widget.dart", "Dart", 44, 0, 5, 49
"/Users/morikazu/Downloads/StudyHub_student/lib/presentation/components/widgets/confirm_question_modal.widget.dart", "Dart", 321, 0, 5, 326
"/Users/morikazu/Downloads/StudyHub_student/lib/presentation/components/widgets/confirm_report_modal_widget.dart", "Dart", 107, 0, 4, 111
"/Users/morikazu/Downloads/StudyHub_student/lib/presentation/components/widgets/confirm_teacher_evaluation_modal_widget.dart", "Dart", 108, 0, 4, 112
"/Users/morikazu/Downloads/StudyHub_student/lib/presentation/components/widgets/edit_profile_widget.dart", "Dart", 96, 0, 5, 101
"/Users/morikazu/Downloads/StudyHub_student/lib/presentation/components/widgets/evaluation_card_widget.dart", "Dart", 122, 0, 5, 127
"/Users/morikazu/Downloads/StudyHub_student/lib/presentation/components/widgets/evaluation_stars_widget.dart", "Dart", 72, 0, 4, 76
"/Users/morikazu/Downloads/StudyHub_student/lib/presentation/components/widgets/evaluation_text_field_widget.dart", "Dart", 55, 0, 4, 59
"/Users/morikazu/Downloads/StudyHub_student/lib/presentation/components/widgets/favorite_teacher_card_widget.dart", "Dart", 89, 1, 5, 95
"/Users/morikazu/Downloads/StudyHub_student/lib/presentation/components/widgets/gender_and_job_input_widget.dart", "Dart", 61, 0, 5, 66
"/Users/morikazu/Downloads/StudyHub_student/lib/presentation/components/widgets/loading_overlay_widget.dart", "Dart", 17, 0, 4, 21
"/Users/morikazu/Downloads/StudyHub_student/lib/presentation/components/widgets/login_by_google_button_widget.dart", "Dart", 44, 0, 5, 49
"/Users/morikazu/Downloads/StudyHub_student/lib/presentation/components/widgets/login_widget.dart", "Dart", 112, 1, 8, 121
"/Users/morikazu/Downloads/StudyHub_student/lib/presentation/components/widgets/notification_card_widget.dart", "Dart", 78, 0, 5, 83
"/Users/morikazu/Downloads/StudyHub_student/lib/presentation/components/widgets/other_function_menu_widget.dart", "Dart", 28, 0, 5, 33
"/Users/morikazu/Downloads/StudyHub_student/lib/presentation/components/widgets/question_and_answer_card_widget.dart", "Dart", 182, 1, 7, 190
"/Users/morikazu/Downloads/StudyHub_student/lib/presentation/components/widgets/question_detail_card_widget.dart", "Dart", 140, 159, 11, 310
"/Users/morikazu/Downloads/StudyHub_student/lib/presentation/components/widgets/question_menu_modal_widget.dart", "Dart", 55, 0, 5, 60
"/Users/morikazu/Downloads/StudyHub_student/lib/presentation/components/widgets/question_pictures_for_confirm_widget.dart", "Dart", 20, 1, 5, 26
"/Users/morikazu/Downloads/StudyHub_student/lib/presentation/components/widgets/question_pictures_widget.dart", "Dart", 43, 0, 6, 49
"/Users/morikazu/Downloads/StudyHub_student/lib/presentation/components/widgets/rank_description_modal.dart", "Dart", 30, 0, 4, 34
"/Users/morikazu/Downloads/StudyHub_student/lib/presentation/components/widgets/reset_password_text_button_widget.dart", "Dart", 32, 0, 5, 37
"/Users/morikazu/Downloads/StudyHub_student/lib/presentation/components/widgets/reset_password_widget.dart", "Dart", 55, 0, 7, 62
"/Users/morikazu/Downloads/StudyHub_student/lib/presentation/components/widgets/sample_widget.dart", "Dart", 20, 0, 4, 24
"/Users/morikazu/Downloads/StudyHub_student/lib/presentation/components/widgets/show_create_question_page_widget.dart", "Dart", 40, 1, 4, 45
"/Users/morikazu/Downloads/StudyHub_student/lib/presentation/components/widgets/show_error_modal_widget.dart", "Dart", 52, 0, 3, 55
"/Users/morikazu/Downloads/StudyHub_student/lib/presentation/components/widgets/sign_up_widget.dart", "Dart", 141, 2, 10, 153
"/Users/morikazu/Downloads/StudyHub_student/lib/presentation/components/widgets/specific_exception_modal_widget.dart", "Dart", 65, 0, 4, 69
"/Users/morikazu/Downloads/StudyHub_student/lib/presentation/components/widgets/student_school_name_and_grade_input_widget.dart", "Dart", 67, 0, 7, 74
"/Users/morikazu/Downloads/StudyHub_student/lib/presentation/components/widgets/teacher_profile_for_confirm_widget.dart", "Dart", 61, 1, 5, 67
"/Users/morikazu/Downloads/StudyHub_student/lib/presentation/components/widgets/teacher_profile_for_evaluation_page_widget.dart", "Dart", 156, 1, 7, 164
"/Users/morikazu/Downloads/StudyHub_student/lib/presentation/components/widgets/teacher_profile_widget.dart", "Dart", 218, 0, 5, 223
"/Users/morikazu/Downloads/StudyHub_student/lib/presentation/components/widgets/terms_of_service_menu_widget.dart", "Dart", 34, 1, 5, 40
"/Users/morikazu/Downloads/StudyHub_student/lib/presentation/components/widgets/user_detail_widget.dart", "Dart", 237, 8, 11, 256
"/Users/morikazu/Downloads/StudyHub_student/lib/presentation/components/widgets/user_name_input_widget.dart", "Dart", 44, 0, 6, 50
"/Users/morikazu/Downloads/StudyHub_student/lib/presentation/controllers/add_favorite_teacher_controller/add_favorite_teacher_controller.dart", "Dart", 30, 0, 6, 36
"/Users/morikazu/Downloads/StudyHub_student/lib/presentation/controllers/add_favorite_teacher_controller/add_favorite_teacher_controller.g.dart", "Dart", 15, 7, 6, 28
"/Users/morikazu/Downloads/StudyHub_student/lib/presentation/controllers/add_question_controller/add_question_contorller.dart", "Dart", 57, 0, 5, 62
"/Users/morikazu/Downloads/StudyHub_student/lib/presentation/controllers/add_question_controller/add_question_contorller.g.dart", "Dart", 15, 7, 6, 28
"/Users/morikazu/Downloads/StudyHub_student/lib/presentation/controllers/add_teacher_evaluation_controller/add_teacher_evaluation_controller.dart", "Dart", 43, 0, 6, 49
"/Users/morikazu/Downloads/StudyHub_student/lib/presentation/controllers/add_teacher_evaluation_controller/add_teacher_evaluation_controller.g.dart", "Dart", 15, 7, 6, 28
"/Users/morikazu/Downloads/StudyHub_student/lib/presentation/controllers/delete_favorite_teacher_controller/delete_favorite_teacher_controller.dart", "Dart", 31, 0, 5, 36
"/Users/morikazu/Downloads/StudyHub_student/lib/presentation/controllers/delete_favorite_teacher_controller/delete_favorite_teacher_controller.g.dart", "Dart", 16, 7, 6, 29
"/Users/morikazu/Downloads/StudyHub_student/lib/presentation/controllers/get_answer_controller/get_answer_controller.dart", "Dart", 16, 0, 6, 22
"/Users/morikazu/Downloads/StudyHub_student/lib/presentation/controllers/get_answer_controller/get_answer_controller.g.dart", "Dart", 131, 18, 30, 179
"/Users/morikazu/Downloads/StudyHub_student/lib/presentation/controllers/get_favorite_teacher_controller/get_favorite_teacher_controller.dart", "Dart", 18, 16, 5, 39
"/Users/morikazu/Downloads/StudyHub_student/lib/presentation/controllers/get_favorite_teacher_controller/get_favorite_teacher_controller.g.dart", "Dart", 16, 7, 6, 29
"/Users/morikazu/Downloads/StudyHub_student/lib/presentation/controllers/get_my_bookmark_controller/get_my_bookmark_controller.dart", "Dart", 23, 0, 6, 29
"/Users/morikazu/Downloads/StudyHub_student/lib/presentation/controllers/get_my_bookmark_controller/get_my_bookmark_controller.g.dart", "Dart", 16, 7, 6, 29
"/Users/morikazu/Downloads/StudyHub_student/lib/presentation/controllers/get_my_profile_controller/get_my_profile_controller.dart", "Dart", 24, 0, 5, 29
"/Users/morikazu/Downloads/StudyHub_student/lib/presentation/controllers/get_my_profile_controller/get_my_profile_controller.g.dart", "Dart", 15, 7, 6, 28
"/Users/morikazu/Downloads/StudyHub_student/lib/presentation/controllers/get_my_question_controller/get_my_question_controller.dart", "Dart", 23, 0, 6, 29
"/Users/morikazu/Downloads/StudyHub_student/lib/presentation/controllers/get_my_question_controller/get_my_question_controller.g.dart", "Dart", 16, 7, 6, 29
"/Users/morikazu/Downloads/StudyHub_student/lib/presentation/controllers/get_popular_teacher_controller/get_popular_teacher_controller.dart", "Dart", 15, 0, 4, 19
"/Users/morikazu/Downloads/StudyHub_student/lib/presentation/controllers/get_popular_teacher_controller/get_popular_teacher_controller.g.dart", "Dart", 16, 7, 6, 29
"/Users/morikazu/Downloads/StudyHub_student/lib/presentation/controllers/get_question_detail_controller/get_question_detail_controller.dart", "Dart", 22, 0, 6, 28
"/Users/morikazu/Downloads/StudyHub_student/lib/presentation/controllers/get_question_detail_controller/get_question_detail_controller.g.dart", "Dart", 133, 18, 30, 181
"/Users/morikazu/Downloads/StudyHub_student/lib/presentation/controllers/get_recommended_quesiotns_controller/get_recommended_questions_controller.dart", "Dart", 24, 0, 6, 30
"/Users/morikazu/Downloads/StudyHub_student/lib/presentation/controllers/get_recommended_quesiotns_controller/get_recommended_questions_controller.g.dart", "Dart", 135, 18, 30, 183
"/Users/morikazu/Downloads/StudyHub_student/lib/presentation/controllers/get_student_controller/get_student_controller.dart", "Dart", 21, 0, 6, 27
"/Users/morikazu/Downloads/StudyHub_student/lib/presentation/controllers/get_student_controller/get_student_controller.g.dart", "Dart", 130, 18, 30, 178
"/Users/morikazu/Downloads/StudyHub_student/lib/presentation/controllers/get_teacher_evaluation_controller/get_teacher_evaluation_controller.dart", "Dart", 18, 0, 5, 23
"/Users/morikazu/Downloads/StudyHub_student/lib/presentation/controllers/get_teacher_evaluation_controller/get_teacher_evaluation_controller.g.dart", "Dart", 135, 18, 30, 183
"/Users/morikazu/Downloads/StudyHub_student/lib/presentation/controllers/get_teacher_profile_controller/get_teacher_profile_controller.dart", "Dart", 22, 0, 5, 27
"/Users/morikazu/Downloads/StudyHub_student/lib/presentation/controllers/get_teacher_profile_controller/get_teacher_profile_controller.g.dart", "Dart", 133, 18, 30, 181
"/Users/morikazu/Downloads/StudyHub_student/lib/presentation/controllers/like_answer_controller/like_answer_controller.dart", "Dart", 44, 0, 12, 56
"/Users/morikazu/Downloads/StudyHub_student/lib/presentation/controllers/like_answer_controller/like_answer_controller.g.dart", "Dart", 15, 7, 6, 28
"/Users/morikazu/Downloads/StudyHub_student/lib/presentation/controllers/profile_update_controller/profile_update_controller.dart", "Dart", 33, 0, 8, 41
"/Users/morikazu/Downloads/StudyHub_student/lib/presentation/controllers/profile_update_controller/profile_update_controller.g.dart", "Dart", 15, 7, 6, 28
"/Users/morikazu/Downloads/StudyHub_student/lib/presentation/controllers/report_question_controller/report_question_controller.dart", "Dart", 24, 0, 6, 30
"/Users/morikazu/Downloads/StudyHub_student/lib/presentation/controllers/report_question_controller/report_question_controller.g.dart", "Dart", 15, 7, 6, 28
"/Users/morikazu/Downloads/StudyHub_student/lib/presentation/controllers/report_teacher_controller/report_teacher_controller.dart", "Dart", 24, 0, 5, 29
"/Users/morikazu/Downloads/StudyHub_student/lib/presentation/controllers/report_teacher_controller/report_teacher_controller.g.dart", "Dart", 15, 7, 6, 28
"/Users/morikazu/Downloads/StudyHub_student/lib/presentation/controllers/sample_controller/sample_controller.dart", "Dart", 25, 6, 6, 37
"/Users/morikazu/Downloads/StudyHub_student/lib/presentation/controllers/sample_controller/sample_controller.g.dart", "Dart", 14, 7, 6, 27
"/Users/morikazu/Downloads/StudyHub_student/lib/presentation/controllers/search_for_teachers_controller/search_for_teachers_controller.dart", "Dart", 18, 0, 5, 23
"/Users/morikazu/Downloads/StudyHub_student/lib/presentation/controllers/search_for_teachers_controller/search_for_teachers_controller.g.dart", "Dart", 133, 18, 30, 181
"/Users/morikazu/Downloads/StudyHub_student/lib/presentation/controllers/search_questions_controller/serach_questions_controller.dart", "Dart", 20, 0, 5, 25
"/Users/morikazu/Downloads/StudyHub_student/lib/presentation/controllers/search_questions_controller/serach_questions_controller.g.dart", "Dart", 153, 19, 31, 203
"/Users/morikazu/Downloads/StudyHub_student/lib/presentation/controllers/student_auth_controller/student_auth_controller.dart", "Dart", 33, 0, 6, 39
"/Users/morikazu/Downloads/StudyHub_student/lib/presentation/controllers/student_auth_controller/student_auth_controller.g.dart", "Dart", 15, 7, 6, 28
"/Users/morikazu/Downloads/StudyHub_student/lib/presentation/controllers/student_controller/student_controller.dart", "Dart", 22, 0, 6, 28
"/Users/morikazu/Downloads/StudyHub_student/lib/presentation/controllers/student_controller/student_controller.g.dart", "Dart", 14, 7, 6, 27
"/Users/morikazu/Downloads/StudyHub_student/lib/presentation/controllers/student_create_controller/student_create_controller.dart", "Dart", 20, 0, 7, 27
"/Users/morikazu/Downloads/StudyHub_student/lib/presentation/controllers/student_create_controller/student_create_controller.g.dart", "Dart", 15, 7, 6, 28
"/Users/morikazu/Downloads/StudyHub_student/lib/presentation/pages/auth_page.dart", "Dart", 127, 1, 6, 134
"/Users/morikazu/Downloads/StudyHub_student/lib/presentation/pages/check_answer_image_page.dart", "Dart", 235, 0, 6, 241
"/Users/morikazu/Downloads/StudyHub_student/lib/presentation/pages/check_question_image_page.dart", "Dart", 240, 0, 6, 246
"/Users/morikazu/Downloads/StudyHub_student/lib/presentation/pages/create_question_page.dart", "Dart", 234, 4, 14, 252
"/Users/morikazu/Downloads/StudyHub_student/lib/presentation/pages/edit_profile_page.dart", "Dart", 208, 0, 15, 223
"/Users/morikazu/Downloads/StudyHub_student/lib/presentation/pages/evaluation_page.dart", "Dart", 189, 1, 8, 198
"/Users/morikazu/Downloads/StudyHub_student/lib/presentation/pages/favorite_teachers_page.dart", "Dart", 82, 1, 6, 89
"/Users/morikazu/Downloads/StudyHub_student/lib/presentation/pages/home_page.dart", "Dart", 186, 0, 6, 192
"/Users/morikazu/Downloads/StudyHub_student/lib/presentation/pages/login_page.dart", "Dart", 25, 2, 3, 30
"/Users/morikazu/Downloads/StudyHub_student/lib/presentation/pages/menu_page.dart", "Dart", 70, 0, 4, 74
"/Users/morikazu/Downloads/StudyHub_student/lib/presentation/pages/my_page.dart", "Dart", 229, 0, 13, 242
"/Users/morikazu/Downloads/StudyHub_student/lib/presentation/pages/notification_page.dart", "Dart", 160, 2, 11, 173
"/Users/morikazu/Downloads/StudyHub_student/lib/presentation/pages/page1.dart", "Dart", 19, 1, 3, 23
"/Users/morikazu/Downloads/StudyHub_student/lib/presentation/pages/page2.dart", "Dart", 39, 1, 5, 45
"/Users/morikazu/Downloads/StudyHub_student/lib/presentation/pages/page3.dart", "Dart", 25, 0, 3, 28
"/Users/morikazu/Downloads/StudyHub_student/lib/presentation/pages/profile_input_page.dart", "Dart", 162, 1, 12, 175
"/Users/morikazu/Downloads/StudyHub_student/lib/presentation/pages/question_and_answer_page.dart", "Dart", 236, 2, 6, 244
"/Users/morikazu/Downloads/StudyHub_student/lib/presentation/pages/report_page.dart", "Dart", 190, 1, 9, 200
"/Users/morikazu/Downloads/StudyHub_student/lib/presentation/pages/reset_password_page.dart", "Dart", 38, 0, 5, 43
"/Users/morikazu/Downloads/StudyHub_student/lib/presentation/pages/search_for_questions_page.dart", "Dart", 209, 0, 7, 216
"/Users/morikazu/Downloads/StudyHub_student/lib/presentation/pages/search_for_teachers_page.dart", "Dart", 229, 0, 9, 238
"/Users/morikazu/Downloads/StudyHub_student/lib/presentation/pages/select_teachers_page.dart", "Dart", 237, 1, 10, 248
"/Users/morikazu/Downloads/StudyHub_student/lib/presentation/pages/teacher_profile_page.dart", "Dart", 116, 0, 5, 121
"/Users/morikazu/Downloads/StudyHub_student/lib/presentation/router/app.dart", "Dart", 35, 0, 4, 39
"/Users/morikazu/Downloads/StudyHub_student/lib/presentation/router/router.dart", "Dart", 236, 0, 7, 243
"/Users/morikazu/Downloads/StudyHub_student/lib/presentation/router/router.g.dart", "Dart", 12, 7, 6, 25
"/Users/morikazu/Downloads/StudyHub_student/lib/presentation/router/scaffold_with_navbar.dart", "Dart", 61, 0, 5, 66
"/Users/morikazu/Downloads/StudyHub_student/lib/presentation/shared/constants/color_set.dart", "Dart", 85, 0, 27, 112
"/Users/morikazu/Downloads/StudyHub_student/lib/presentation/shared/constants/font_set.dart", "Dart", 4, 0, 0, 4
"/Users/morikazu/Downloads/StudyHub_student/lib/presentation/shared/constants/font_size_set.dart", "Dart", 16, 0, 4, 20
"/Users/morikazu/Downloads/StudyHub_student/lib/presentation/shared/constants/font_weight_set.dart", "Dart", 5, 0, 0, 5
"/Users/morikazu/Downloads/StudyHub_student/lib/presentation/shared/constants/l10n.dart", "Dart", 215, 19, 36, 270
"/Users/morikazu/Downloads/StudyHub_student/lib/presentation/shared/constants/padding_set.dart", "Dart", 13, 0, 4, 17
"/Users/morikazu/Downloads/StudyHub_student/lib/presentation/shared/constants/page_path.dart", "Dart", 82, 3, 3, 88
"/Users/morikazu/Downloads/StudyHub_student/lib/presentation/shared/utils/accessibility.dart", "Dart", 17, 0, 5, 22
"/Users/morikazu/Downloads/StudyHub_student/lib/service.dart", "Dart", 11, 1, 3, 15
"/Users/morikazu/Downloads/StudyHub_student/lib/utils/accessibility.dart", "Dart", 10, 0, 3, 13
"/Users/morikazu/Downloads/StudyHub_student/lib/utils/zip.dart", "Dart", 7, 0, 2, 9
"Total", "-", 17033, 853, 2475, 20361