"filename", "language", "Dart", "comment", "blank", "total"
"/Users/morikazu/Downloads/StudyHub_student/lib/application/answer/application_service/answer_dto.dart", "Dart", 33, 0, 4, 37
"/Users/morikazu/Downloads/StudyHub_student/lib/application/answer/application_service/get_answer_use_case.dart", "Dart", 11, 0, 4, 15
"/Users/morikazu/Downloads/StudyHub_student/lib/application/answer/application_service/i_get_answer_query_service.dart", "Dart", 5, 0, 2, 7
"/Users/morikazu/Downloads/StudyHub_student/lib/application/answer/exception/answer_use_case_exception.dart", "Dart", 8, 0, 2, 10
"/Users/morikazu/Downloads/StudyHub_student/lib/application/answer/exception/answer_use_case_exception_detail.dart", "Dart", 8, 0, 5, 13
"/Users/morikazu/Downloads/StudyHub_student/lib/application/blockings/application_service/blockings_add_use_case.dart", "Dart", 20, 0, 8, 28
"/Users/morikazu/Downloads/StudyHub_student/lib/application/blockings/application_service/blockings_delete_use_case.dart", "Dart", 24, 0, 7, 31
"/Users/morikazu/Downloads/StudyHub_student/lib/application/blockings/application_service/get_blocking_dto.dart", "Dart", 12, 0, 4, 16
"/Users/morikazu/Downloads/StudyHub_student/lib/application/blockings/application_service/get_blockings_use_case.dart", "Dart", 17, 0, 4, 21
"/Users/morikazu/Downloads/StudyHub_student/lib/application/blockings/application_service/i_get_blockings_query_service.dart", "Dart", 5, 0, 2, 7
"/Users/morikazu/Downloads/StudyHub_student/lib/application/blockings/exception/blockings_use_case_exception.dart", "Dart", 8, 0, 2, 10
"/Users/morikazu/Downloads/StudyHub_student/lib/application/blockings/exception/blockings_use_case_exception_detail.dart", "Dart", 8, 0, 5, 13
"/Users/morikazu/Downloads/StudyHub_student/lib/application/bookmarks/application_service/bookmarks_add_use_case.dart", "Dart", 20, 0, 8, 28
"/Users/morikazu/Downloads/StudyHub_student/lib/application/bookmarks/application_service/bookmarks_delete_use_case.dart", "Dart", 24, 0, 7, 31
"/Users/morikazu/Downloads/StudyHub_student/lib/application/bookmarks/application_service/get_my_bookmarks_use_case.dart", "Dart", 17, 0, 4, 21
"/Users/morikazu/Downloads/StudyHub_student/lib/application/bookmarks/application_service/i_get_bookmarks_query_service.dart", "Dart", 5, 0, 2, 7
"/Users/morikazu/Downloads/StudyHub_student/lib/application/bookmarks/exception/bookmarks_use_case_exception.dart", "Dart", 8, 0, 2, 10
"/Users/morikazu/Downloads/StudyHub_student/lib/application/bookmarks/exception/bookmarks_use_case_exception_detail.dart", "Dart", 8, 0, 5, 13
"/Users/morikazu/Downloads/StudyHub_student/lib/application/di/answer/query_service/answer_query_service_provider.dart", "Dart", 32, 0, 4, 36
"/Users/morikazu/Downloads/StudyHub_student/lib/application/di/answer/query_service/answer_query_service_provider.g.dart", "Dart", 16, 7, 6, 29
"/Users/morikazu/Downloads/StudyHub_student/lib/application/di/answer/repository/answer_repository_provider.dart", "Dart", 17, 0, 4, 21
"/Users/morikazu/Downloads/StudyHub_student/lib/application/di/answer/repository/answer_repository_provider.g.dart", "Dart", 15, 7, 6, 28
"/Users/morikazu/Downloads/StudyHub_student/lib/application/di/bookmarks/query_service/get_my_bookmarks_query_service_provider.dart", "Dart", 35, 0, 4, 39
"/Users/morikazu/Downloads/StudyHub_student/lib/application/di/bookmarks/query_service/get_my_bookmarks_query_service_provider.g.dart", "Dart", 16, 7, 6, 29
"/Users/morikazu/Downloads/StudyHub_student/lib/application/di/bookmarks/repository/get_my_bookmarks_repository_provider.dart", "Dart", 18, 0, 4, 22
"/Users/morikazu/Downloads/StudyHub_student/lib/application/di/bookmarks/repository/get_my_bookmarks_repository_provider.g.dart", "Dart", 16, 7, 6, 29
"/Users/morikazu/Downloads/StudyHub_student/lib/application/di/favorite_teacher/query_service/get_favorite_teacher_query_service_provider.dart", "Dart", 27, 0, 4, 31
"/Users/morikazu/Downloads/StudyHub_student/lib/application/di/favorite_teacher/query_service/get_favorite_teacher_query_service_provider.g.dart", "Dart", 16, 7, 6, 29
"/Users/morikazu/Downloads/StudyHub_student/lib/application/di/favorite_teacher/repository/favorite_teacher_repository_provider.dart", "Dart", 18, 0, 4, 22
"/Users/morikazu/Downloads/StudyHub_student/lib/application/di/favorite_teacher/repository/favorite_teacher_repository_provider.g.dart", "Dart", 16, 7, 6, 29
"/Users/morikazu/Downloads/StudyHub_student/lib/application/di/photo/photo_repository_provider.dart", "Dart", 17, 0, 4, 21
"/Users/morikazu/Downloads/StudyHub_student/lib/application/di/photo/photo_repository_provider.g.dart", "Dart", 14, 7, 6, 27
"/Users/morikazu/Downloads/StudyHub_student/lib/application/di/question/factory/question_factory_provider.dart", "Dart", 20, 0, 4, 24
"/Users/morikazu/Downloads/StudyHub_student/lib/application/di/question/factory/question_factory_provider.g.dart", "Dart", 14, 7, 6, 27
"/Users/morikazu/Downloads/StudyHub_student/lib/application/di/question/query_service/get_question_query_service_provider.dart", "Dart", 31, 0, 4, 35
"/Users/morikazu/Downloads/StudyHub_student/lib/application/di/question/query_service/get_question_query_service_provider.g.dart", "Dart", 16, 7, 6, 29
"/Users/morikazu/Downloads/StudyHub_student/lib/application/di/question/repository/question_repository_provider.dart", "Dart", 17, 0, 4, 21
"/Users/morikazu/Downloads/StudyHub_student/lib/application/di/question/repository/question_repository_provider.g.dart", "Dart", 15, 7, 6, 28
"/Users/morikazu/Downloads/StudyHub_student/lib/application/di/question_detail/question_detail_query_service_provider.dart", "Dart", 21, 0, 4, 25
"/Users/morikazu/Downloads/StudyHub_student/lib/application/di/question_detail/question_detail_query_service_provider.g.dart", "Dart", 16, 7, 6, 29
"/Users/morikazu/Downloads/StudyHub_student/lib/application/di/school/school_repository_provider.dart", "Dart", 17, 0, 4, 21
"/Users/morikazu/Downloads/StudyHub_student/lib/application/di/school/school_repository_provider.g.dart", "Dart", 15, 7, 6, 28
"/Users/morikazu/Downloads/StudyHub_student/lib/application/di/session/session_provider.dart", "Dart", 34, 0, 7, 41
"/Users/morikazu/Downloads/StudyHub_student/lib/application/di/session/session_provider.g.dart", "Dart", 47, 10, 12, 69
"/Users/morikazu/Downloads/StudyHub_student/lib/application/di/student/student_provider.dart", "Dart", 17, 0, 4, 21
"/Users/morikazu/Downloads/StudyHub_student/lib/application/di/student/student_provider.g.dart", "Dart", 15, 7, 6, 28
"/Users/morikazu/Downloads/StudyHub_student/lib/application/di/student/student_repository_provider.dart", "Dart", 17, 0, 4, 21
"/Users/morikazu/Downloads/StudyHub_student/lib/application/di/student/student_repository_provider.g.dart", "Dart", 15, 7, 6, 28
"/Users/morikazu/Downloads/StudyHub_student/lib/application/di/student_auth/student_auth_provider.dart", "Dart", 42, 0, 6, 48
"/Users/morikazu/Downloads/StudyHub_student/lib/application/di/student_auth/student_auth_provider.g.dart", "Dart", 42, 9, 10, 61
"/Users/morikazu/Downloads/StudyHub_student/lib/application/di/teacher/get_popular_teacher_query_service_provider.dart", "Dart", 22, 0, 4, 26
"/Users/morikazu/Downloads/StudyHub_student/lib/application/di/teacher/get_popular_teacher_query_service_provider.g.dart", "Dart", 16, 7, 6, 29
"/Users/morikazu/Downloads/StudyHub_student/lib/application/di/teacher/get_teacher_profile_query_service.dart", "Dart", 30, 0, 4, 34
"/Users/morikazu/Downloads/StudyHub_student/lib/application/di/teacher/get_teacher_profile_query_service.g.dart", "Dart", 16, 7, 6, 29
"/Users/morikazu/Downloads/StudyHub_student/lib/application/di/teacher/search_for_teachers_query_service.dart", "Dart", 21, 0, 4, 25
"/Users/morikazu/Downloads/StudyHub_student/lib/application/di/teacher/search_for_teachers_query_service.g.dart", "Dart", 16, 7, 6, 29
"/Users/morikazu/Downloads/StudyHub_student/lib/application/di/teacher/teacher_provider.dart", "Dart", 17, 0, 4, 21
"/Users/morikazu/Downloads/StudyHub_student/lib/application/di/teacher/teacher_provider.g.dart", "Dart", 15, 7, 6, 28
"/Users/morikazu/Downloads/StudyHub_student/lib/application/di/teacher_evaluation/teacher_evaluation_repository_provider.dart", "Dart", 18, 0, 4, 22
"/Users/morikazu/Downloads/StudyHub_student/lib/application/di/teacher_evaluation/teacher_evaluation_repository_provider.g.dart", "Dart", 16, 7, 6, 29
"/Users/morikazu/Downloads/StudyHub_student/lib/application/favorite_teachers/application_service/favorite_teachers_add_use_case.dart", "Dart", 21, 0, 8, 29
"/Users/morikazu/Downloads/StudyHub_student/lib/application/favorite_teachers/application_service/favorite_teachers_delete_use_case.dart", "Dart", 24, 0, 7, 31
"/Users/morikazu/Downloads/StudyHub_student/lib/application/favorite_teachers/application_service/get_favorite_teacher_dto.dart", "Dart", 20, 0, 4, 24
"/Users/morikazu/Downloads/StudyHub_student/lib/application/favorite_teachers/application_service/get_favorite_teacher_use_case.dart", "Dart", 17, 0, 5, 22
"/Users/morikazu/Downloads/StudyHub_student/lib/application/favorite_teachers/application_service/i_get_favorite_teacher_query_service.dart", "Dart", 5, 0, 2, 7
"/Users/morikazu/Downloads/StudyHub_student/lib/application/favorite_teachers/exception/favorite_teachers_use_case_exception.dart", "Dart", 8, 0, 2, 10
"/Users/morikazu/Downloads/StudyHub_student/lib/application/favorite_teachers/exception/favorite_teachers_use_case_exception_detail.dart", "Dart", 8, 0, 5, 13
"/Users/morikazu/Downloads/StudyHub_student/lib/application/question/application_service/get_my_questions_use_case.dart", "Dart", 17, 0, 3, 20
"/Users/morikazu/Downloads/StudyHub_student/lib/application/question/application_service/get_question_detail_use_case.dart", "Dart", 35, 0, 4, 39
"/Users/morikazu/Downloads/StudyHub_student/lib/application/question/application_service/get_recommended_questions_use_case.dart", "Dart", 21, 0, 3, 24
"/Users/morikazu/Downloads/StudyHub_student/lib/application/question/application_service/i_get_my_questions_query_service.dart", "Dart", 5, 0, 2, 7
"/Users/morikazu/Downloads/StudyHub_student/lib/application/question/application_service/i_get_question_detail_query_service.dart", "Dart", 5, 0, 2, 7
"/Users/morikazu/Downloads/StudyHub_student/lib/application/question/application_service/i_get_recommended_questions_query_service.dart", "Dart", 9, 0, 2, 11
"/Users/morikazu/Downloads/StudyHub_student/lib/application/question/application_service/i_search_for_questions_query_service.dart", "Dart", 4, 0, 2, 6
"/Users/morikazu/Downloads/StudyHub_student/lib/application/question/application_service/question_create_use_case.dart", "Dart", 59, 0, 10, 69
"/Users/morikazu/Downloads/StudyHub_student/lib/application/question/application_service/question_delete_use_case.dart", "Dart", 37, 0, 9, 46
"/Users/morikazu/Downloads/StudyHub_student/lib/application/question/application_service/question_detail_dto.dart", "Dart", 24, 0, 4, 28
"/Users/morikazu/Downloads/StudyHub_student/lib/application/question/application_service/question_edit_command.dart", "Dart", 24, 0, 4, 28
"/Users/morikazu/Downloads/StudyHub_student/lib/application/question/application_service/question_edit_use_case.dart", "Dart", 76, 3, 17, 96
"/Users/morikazu/Downloads/StudyHub_student/lib/application/question/application_service/search_for_question_use_case.dart", "Dart", 12, 0, 4, 16
"/Users/morikazu/Downloads/StudyHub_student/lib/application/question/application_service/utils/photo_processing.dart", "Dart", 62, 0, 16, 78
"/Users/morikazu/Downloads/StudyHub_student/lib/application/question/exception/question_use_case_exception.dart", "Dart", 8, 0, 2, 10
"/Users/morikazu/Downloads/StudyHub_student/lib/application/question/exception/question_use_case_exception_detail.dart", "Dart", 12, 0, 5, 17
"/Users/morikazu/Downloads/StudyHub_student/lib/application/report/application_service/report_submit_command.dart", "Dart", 17, 0, 4, 21
"/Users/morikazu/Downloads/StudyHub_student/lib/application/report/application_service/report_submit_use_case.dart", "Dart", 27, 0, 6, 33
"/Users/morikazu/Downloads/StudyHub_student/lib/application/shared/application_service/question_card_dto.dart", "Dart", 28, 0, 4, 32
"/Users/morikazu/Downloads/StudyHub_student/lib/application/shared/exception/use_case_exception.dart", "Dart", 13, 0, 4, 17
"/Users/morikazu/Downloads/StudyHub_student/lib/application/shared/exception/use_case_exception_detail.dart", "Dart", 4, 0, 2, 6
"/Users/morikazu/Downloads/StudyHub_student/lib/application/shared/flavor/flavor.dart", "Dart", 5, 0, 1, 6
"/Users/morikazu/Downloads/StudyHub_student/lib/application/shared/flavor/flavor_config.dart", "Dart", 14, 0, 3, 17
"/Users/morikazu/Downloads/StudyHub_student/lib/application/shared/session/i_session_provider.dart", "Dart", 4, 0, 2, 6
"/Users/morikazu/Downloads/StudyHub_student/lib/application/shared/session/session.dart", "Dart", 8, 0, 4, 12
"/Users/morikazu/Downloads/StudyHub_student/lib/application/student/application_service/get_my_profile_dto.dart", "Dart", 20, 0, 4, 24
"/Users/morikazu/Downloads/StudyHub_student/lib/application/student/application_service/get_my_profile_use_case.dart", "Dart", 23, 0, 4, 27
"/Users/morikazu/Downloads/StudyHub_student/lib/application/student/application_service/get_student_dto.dart", "Dart", 52, 0, 5, 57
"/Users/morikazu/Downloads/StudyHub_student/lib/application/student/application_service/get_student_use_case.dart", "Dart", 22, 0, 4, 26
"/Users/morikazu/Downloads/StudyHub_student/lib/application/student/application_service/i_get_my_profile_query_service.dart", "Dart", 5, 0, 2, 7
"/Users/morikazu/Downloads/StudyHub_student/lib/application/student/application_service/profile_update_command.dart", "Dart", 30, 0, 4, 34
"/Users/morikazu/Downloads/StudyHub_student/lib/application/student/application_service/profile_update_use_case.dart", "Dart", 77, 0, 16, 93
"/Users/morikazu/Downloads/StudyHub_student/lib/application/student/application_service/student_create_use_case.dart", "Dart", 61, 7, 13, 81
"/Users/morikazu/Downloads/StudyHub_student/lib/application/student/application_service/student_delete_use_case.dart", "Dart", 32, 1, 3, 36
"/Users/morikazu/Downloads/StudyHub_student/lib/application/student/application_service/utils/photo_processing.dart", "Dart", 43, 0, 11, 54
"/Users/morikazu/Downloads/StudyHub_student/lib/application/student/exception/student_use_case_exception.dart", "Dart", 8, 0, 2, 10
"/Users/morikazu/Downloads/StudyHub_student/lib/application/student/exception/student_use_case_exception_detail.dart", "Dart", 13, 0, 5, 18
"/Users/morikazu/Downloads/StudyHub_student/lib/application/student_auth/application_service/i_get_student_auth_query_service.dart", "Dart", 4, 0, 2, 6
"/Users/morikazu/Downloads/StudyHub_student/lib/application/student_auth/application_service/sign_in_use_case.dart", "Dart", 17, 0, 4, 21
"/Users/morikazu/Downloads/StudyHub_student/lib/application/student_auth/application_service/sign_out_use_case.dart", "Dart", 10, 0, 3, 13
"/Users/morikazu/Downloads/StudyHub_student/lib/application/student_auth/application_service/student_auth_info_without_password.dart", "Dart", 17, 0, 4, 21
"/Users/morikazu/Downloads/StudyHub_student/lib/application/student_auth/application_service/update_student_auth_info_command.dart", "Dart", 11, 0, 3, 14
"/Users/morikazu/Downloads/StudyHub_student/lib/application/student_auth/application_service/update_student_auth_info_use_case.dart", "Dart", 21, 0, 5, 26
"/Users/morikazu/Downloads/StudyHub_student/lib/application/student_auth/exception/student_auth_use_case_exception.dart", "Dart", 8, 0, 2, 10
"/Users/morikazu/Downloads/StudyHub_student/lib/application/student_auth/exception/student_auth_use_case_exception_detail.dart", "Dart", 10, 10, 6, 26
"/Users/morikazu/Downloads/StudyHub_student/lib/application/teacher/application_service/get_popular_teachers_use_case.dart", "Dart", 9, 0, 3, 12
"/Users/morikazu/Downloads/StudyHub_student/lib/application/teacher/application_service/get_teacher_profile_dto.dart", "Dart", 39, 0, 3, 42
"/Users/morikazu/Downloads/StudyHub_student/lib/application/teacher/application_service/get_teacher_profile_use_case.dart", "Dart", 15, 0, 3, 18
"/Users/morikazu/Downloads/StudyHub_student/lib/application/teacher/application_service/i_get_popular_teachers_query_service.dart", "Dart", 4, 0, 2, 6
"/Users/morikazu/Downloads/StudyHub_student/lib/application/teacher/application_service/i_get_teacher_profile_query_service.dart", "Dart", 5, 0, 2, 7
"/Users/morikazu/Downloads/StudyHub_student/lib/application/teacher/application_service/i_search_for_teachers_query_service.dart", "Dart", 4, 0, 2, 6
"/Users/morikazu/Downloads/StudyHub_student/lib/application/teacher/application_service/search_for_teachers_dto.dart", "Dart", 20, 0, 4, 24
"/Users/morikazu/Downloads/StudyHub_student/lib/application/teacher/application_service/search_for_teachers_use_case.dart", "Dart", 14, 0, 3, 17
"/Users/morikazu/Downloads/StudyHub_student/lib/application/teacher_evaluation/application_service/get_teacher_evaluation_dto.dart", "Dart", 25, 0, 4, 29
"/Users/morikazu/Downloads/StudyHub_student/lib/application/teacher_evaluation/application_service/get_teacher_evaluation_use_case.dart", "Dart", 26, 0, 8, 34
"/Users/morikazu/Downloads/StudyHub_student/lib/application/teacher_evaluation/application_service/teacher_evaluation_add_use_case.dart", "Dart", 32, 0, 7, 39
"/Users/morikazu/Downloads/StudyHub_student/lib/application/teacher_evaluation/exception/teacher_evaluation_use_case_exception.dart", "Dart", 8, 0, 2, 10
"/Users/morikazu/Downloads/StudyHub_student/lib/application/teacher_evaluation/exception/teacher_evaluation_use_case_exception_detail.dart", "Dart", 8, 0, 5, 13
"/Users/morikazu/Downloads/StudyHub_student/lib/domain/answer_list/exception/answer_domain_exception.dart", "Dart", -8, 0, -2, -10
"/Users/morikazu/Downloads/StudyHub_student/lib/domain/answer_list/exception/answer_domain_exception_detail.dart", "Dart", -20, 0, -5, -25
"/Users/morikazu/Downloads/StudyHub_student/lib/domain/answer_list/models/answer.dart", "Dart", -32, -8, -6, -46
"/Users/morikazu/Downloads/StudyHub_student/lib/domain/answer_list/models/answer_id.dart", "Dart", -26, 0, -6, -32
"/Users/morikazu/Downloads/StudyHub_student/lib/domain/answer_list/models/answer_like.dart", "Dart", -45, 0, -8, -53
"/Users/morikazu/Downloads/StudyHub_student/lib/domain/answer_list/models/answer_list.dart", "Dart", -8, -8, -7, -23
"/Users/morikazu/Downloads/StudyHub_student/lib/domain/answer_list/models/answer_photo.dart", "Dart", -29, 0, -5, -34
"/Users/morikazu/Downloads/StudyHub_student/lib/domain/answer_list/models/answer_photo_format.dart", "Dart", -11, 0, -4, -15
"/Users/morikazu/Downloads/StudyHub_student/lib/domain/answer_list/models/answer_photo_path.dart", "Dart", -16, 0, -4, -20
"/Users/morikazu/Downloads/StudyHub_student/lib/domain/answer_list/models/answer_photo_path_list.dart", "Dart", -15, 0, -4, -19
"/Users/morikazu/Downloads/StudyHub_student/lib/domain/answer_list/models/answer_text.dart", "Dart", -17, 0, -3, -20
"/Users/morikazu/Downloads/StudyHub_student/lib/domain/answer_list/models/i_answer_repository.dart", "Dart", -5, 0, -2, -7
"/Users/morikazu/Downloads/StudyHub_student/lib/domain/blockings/exception/blockings_domain_exception.dart", "Dart", -8, 0, -2, -10
"/Users/morikazu/Downloads/StudyHub_student/lib/domain/blockings/exception/blockings_domain_exception_detail.dart", "Dart", -9, 0, -5, -14
"/Users/morikazu/Downloads/StudyHub_student/lib/domain/blockings/models/blockings.dart", "Dart", -39, 0, -9, -48
"/Users/morikazu/Downloads/StudyHub_student/lib/domain/blockings/models/i_blockings_repository.dart", "Dart", -6, 0, -2, -8
"/Users/morikazu/Downloads/StudyHub_student/lib/domain/bookmarks/exception/bookmarks_domain_exception.dart", "Dart", -8, 0, -2, -10
"/Users/morikazu/Downloads/StudyHub_student/lib/domain/bookmarks/exception/bookmarks_domain_exception_detail.dart", "Dart", -9, 0, -5, -14
"/Users/morikazu/Downloads/StudyHub_student/lib/domain/bookmarks/models/bookmarks.dart", "Dart", -34, 0, -9, -43
"/Users/morikazu/Downloads/StudyHub_student/lib/domain/bookmarks/models/i_bookmarks_repository.dart", "Dart", -6, 0, -2, -8
"/Users/morikazu/Downloads/StudyHub_student/lib/domain/favorite_teachers/exception/favorite_teachers_domain_exception.dart", "Dart", -8, 0, -2, -10
"/Users/morikazu/Downloads/StudyHub_student/lib/domain/favorite_teachers/exception/favorite_teachers_domain_exception_detail.dart", "Dart", -12, 0, -6, -18
"/Users/morikazu/Downloads/StudyHub_student/lib/domain/favorite_teachers/models/favorite_teachers.dart", "Dart", -44, 0, -9, -53
"/Users/morikazu/Downloads/StudyHub_student/lib/domain/favorite_teachers/models/i_favorite_teachers_repository.dart", "Dart", -6, 0, -2, -8
"/Users/morikazu/Downloads/StudyHub_student/lib/domain/photo/models/i_profile_photo_repository.dart", "Dart", -8, 0, -2, -10
"/Users/morikazu/Downloads/StudyHub_student/lib/domain/photo/models/photo.dart", "Dart", -27, 0, -6, -33
"/Users/morikazu/Downloads/StudyHub_student/lib/domain/photo/models/photo_path.dart", "Dart", -21, 0, -6, -27
"/Users/morikazu/Downloads/StudyHub_student/lib/domain/photo/models/photo_path_list.dart", "Dart", -11, 0, -6, -17
"/Users/morikazu/Downloads/StudyHub_student/lib/domain/question/exception/question_domain_exception.dart", "Dart", -8, 0, -2, -10
"/Users/morikazu/Downloads/StudyHub_student/lib/domain/question/exception/question_domain_exception_detail.dart", "Dart", -26, 0, -5, -31
"/Users/morikazu/Downloads/StudyHub_student/lib/domain/question/models/i_question_factory.dart", "Dart", -17, -8, -4, -29
"/Users/morikazu/Downloads/StudyHub_student/lib/domain/question/models/i_question_repository.dart", "Dart", -8, 0, -2, -10
"/Users/morikazu/Downloads/StudyHub_student/lib/domain/question/models/question.dart", "Dart", -88, -2, -16, -106
"/Users/morikazu/Downloads/StudyHub_student/lib/domain/question/models/question_id.dart", "Dart", -26, 0, -6, -32
"/Users/morikazu/Downloads/StudyHub_student/lib/domain/question/models/question_photo.dart", "Dart", -30, 0, -6, -36
"/Users/morikazu/Downloads/StudyHub_student/lib/domain/question/models/question_photo_format.dart", "Dart", -11, 0, -4, -15
"/Users/morikazu/Downloads/StudyHub_student/lib/domain/question/models/question_photo_path.dart", "Dart", -19, 0, -5, -24
"/Users/morikazu/Downloads/StudyHub_student/lib/domain/question/models/question_photo_path_list.dart", "Dart", -15, -7, -5, -27
"/Users/morikazu/Downloads/StudyHub_student/lib/domain/question/models/question_text.dart", "Dart", -22, 0, -3, -25
"/Users/morikazu/Downloads/StudyHub_student/lib/domain/question/models/question_title.dart", "Dart", -18, 0, -3, -21
"/Users/morikazu/Downloads/StudyHub_student/lib/domain/question/models/seen_count.dart", "Dart", -41, -2, -9, -52
"/Users/morikazu/Downloads/StudyHub_student/lib/domain/question/models/selected_teacher_list.dart", "Dart", -15, 0, -5, -20
"/Users/morikazu/Downloads/StudyHub_student/lib/domain/report/exception/report_domain_exception.dart", "Dart", -8, 0, -2, -10
"/Users/morikazu/Downloads/StudyHub_student/lib/domain/report/exception/report_domain_exception_detail.dart", "Dart", -11, 0, -5, -16
"/Users/morikazu/Downloads/StudyHub_student/lib/domain/report/models/i_report_repository.dart", "Dart", -4, 0, -2, -6
"/Users/morikazu/Downloads/StudyHub_student/lib/domain/report/models/report.dart", "Dart", -15, 0, -3, -18
"/Users/morikazu/Downloads/StudyHub_student/lib/domain/report/models/report_reason.dart", "Dart", -15, 0, -6, -21
"/Users/morikazu/Downloads/StudyHub_student/lib/domain/report/models/report_text.dart", "Dart", -21, 0, -4, -25
"/Users/morikazu/Downloads/StudyHub_student/lib/domain/school/models/i_school_repository.dart", "Dart", -5, 0, -2, -7
"/Users/morikazu/Downloads/StudyHub_student/lib/domain/school/models/school.dart", "Dart", -19, 0, -6, -25
"/Users/morikazu/Downloads/StudyHub_student/lib/domain/school/models/school_type.dart", "Dart", -11, 0, -4, -15
"/Users/morikazu/Downloads/StudyHub_student/lib/domain/school/services/school_service.dart", "Dart", -13, 0, -4, -17
"/Users/morikazu/Downloads/StudyHub_student/lib/domain/shared/domain_exception.dart", "Dart", -13, 0, -4, -17
"/Users/morikazu/Downloads/StudyHub_student/lib/domain/shared/domain_exception_detail.dart", "Dart", -4, 0, -2, -6
"/Users/morikazu/Downloads/StudyHub_student/lib/domain/shared/name.dart", "Dart", -31, 0, -5, -36
"/Users/morikazu/Downloads/StudyHub_student/lib/domain/shared/profile_photo.dart", "Dart", -34, 0, -6, -40
"/Users/morikazu/Downloads/StudyHub_student/lib/domain/shared/profile_photo_format.dart", "Dart", -11, 0, -4, -15
"/Users/morikazu/Downloads/StudyHub_student/lib/domain/shared/profile_photo_path.dart", "Dart", -16, 0, -4, -20
"/Users/morikazu/Downloads/StudyHub_student/lib/domain/shared/subject.dart", "Dart", -12, 0, -4, -16
"/Users/morikazu/Downloads/StudyHub_student/lib/domain/student/exception/student_domain_exception.dart", "Dart", -8, 0, -2, -10
"/Users/morikazu/Downloads/StudyHub_student/lib/domain/student/exception/student_domain_exception_detail.dart", "Dart", -19, 0, -5, -24
"/Users/morikazu/Downloads/StudyHub_student/lib/domain/student/models/gender.dart", "Dart", -12, 0, -4, -16
"/Users/morikazu/Downloads/StudyHub_student/lib/domain/student/models/grade_or_graduate_status.dart", "Dart", -13, 0, -4, -17
"/Users/morikazu/Downloads/StudyHub_student/lib/domain/student/models/i_student_repository.dart", "Dart", -7, 0, -2, -9
"/Users/morikazu/Downloads/StudyHub_student/lib/domain/student/models/occupation.dart", "Dart", -12, 0, -4, -16
"/Users/morikazu/Downloads/StudyHub_student/lib/domain/student/models/question_count.dart", "Dart", -38, 0, -8, -46
"/Users/morikazu/Downloads/StudyHub_student/lib/domain/student/models/school_name.dart", "Dart", 0, -18, -5, -23
"/Users/morikazu/Downloads/StudyHub_student/lib/domain/student/models/status.dart", "Dart", -13, 0, -5, -18
"/Users/morikazu/Downloads/StudyHub_student/lib/domain/student/models/student.dart", "Dart", -116, 0, -15, -131
"/Users/morikazu/Downloads/StudyHub_student/lib/domain/student/models/student_id.dart", "Dart", -26, 0, -6, -32
"/Users/morikazu/Downloads/StudyHub_student/lib/domain/student_auth/exception/student_auth_domain_exception.dart", "Dart", -8, 0, -2, -10
"/Users/morikazu/Downloads/StudyHub_student/lib/domain/student_auth/exception/student_auth_domain_exception_detail.dart", "Dart", -13, 0, -5, -18
"/Users/morikazu/Downloads/StudyHub_student/lib/domain/student_auth/models/email_address.dart", "Dart", -36, 0, -6, -42
"/Users/morikazu/Downloads/StudyHub_student/lib/domain/student_auth/models/i_student_auth_repository.dart", "Dart", -20, 0, -2, -22
"/Users/morikazu/Downloads/StudyHub_student/lib/domain/student_auth/models/password.dart", "Dart", -39, 0, -7, -46
"/Users/morikazu/Downloads/StudyHub_student/lib/domain/student_auth/models/student_auth_info.dart", "Dart", -32, 0, -7, -39
"/Users/morikazu/Downloads/StudyHub_student/lib/domain/teacher/exception/teacher_domain_exception.dart", "Dart", -8, 0, -2, -10
"/Users/morikazu/Downloads/StudyHub_student/lib/domain/teacher/exception/teacher_domain_exception_detail.dart", "Dart", -16, 0, -5, -21
"/Users/morikazu/Downloads/StudyHub_student/lib/domain/teacher/models/bio.dart", "Dart", -13, 0, -4, -17
"/Users/morikazu/Downloads/StudyHub_student/lib/domain/teacher/models/graduated.dart", "Dart", -10, 0, -4, -14
"/Users/morikazu/Downloads/StudyHub_student/lib/domain/teacher/models/high_school.dart", "Dart", -4, 0, -2, -6
"/Users/morikazu/Downloads/StudyHub_student/lib/domain/teacher/models/i_teacher_repository.dart", "Dart", -5, 0, -2, -7
"/Users/morikazu/Downloads/StudyHub_student/lib/domain/teacher/models/introduction.dart", "Dart", -13, 0, -4, -17
"/Users/morikazu/Downloads/StudyHub_student/lib/domain/teacher/models/rating.dart", "Dart", -14, 0, -4, -18
"/Users/morikazu/Downloads/StudyHub_student/lib/domain/teacher/models/teacher.dart", "Dart", -48, 0, -4, -52
"/Users/morikazu/Downloads/StudyHub_student/lib/domain/teacher/models/teacher_id.dart", "Dart", -26, 0, -6, -32
"/Users/morikazu/Downloads/StudyHub_student/lib/domain/teacher/models/university.dart", "Dart", -11, 0, -4, -15
"/Users/morikazu/Downloads/StudyHub_student/lib/domain/teacher_evaluation/exception/teacher_evaluation_domain_exception.dart", "Dart", -8, 0, -2, -10
"/Users/morikazu/Downloads/StudyHub_student/lib/domain/teacher_evaluation/exception/teacher_evaluation_domain_exception_detail.dart", "Dart", -13, 0, -6, -19
"/Users/morikazu/Downloads/StudyHub_student/lib/domain/teacher_evaluation/models/i_teacher_evaluation_repository.dart", "Dart", -6, 0, -2, -8
"/Users/morikazu/Downloads/StudyHub_student/lib/domain/teacher_evaluation/models/teacher_evaluation.dart", "Dart", -27, 0, -4, -31
"/Users/morikazu/Downloads/StudyHub_student/lib/domain/teacher_evaluation/models/teacher_evaluation_comment.dart", "Dart", -14, 0, -4, -18
"/Users/morikazu/Downloads/StudyHub_student/lib/domain/teacher_evaluation/models/teacher_evaluation_rating.dart", "Dart", -14, 0, -5, -19
"Total", "-", 701, 120, 178, 999